the infestation	house had bunch termites started noticing bugs wood work crumbling called agency come check told had fumigate house
the bug	felt something crawling leg saw bug jumped swatted bug scurried couch stood table someone come smash bug
theater performance	had seen play performed go girlfriend asked performance thought tickets saw play liked do planned go
famous	had dream everyone loved woke made goal make dream come
PERSON paints her nails	wants try painting nails color looks nail polish decides paints nail 's done nails look nail color
dirty environment	textbook went missing tried look laundry room dust flying desk managed find book bin blister broke mouth
fast fight	chewing gum glass girl sat asked stop chewing chewed gum hearing ended fighting
pillows	trying sleep pillow annoyed sleep decided sleep pillow woke neck ache
wrong pill	had take pill swallowed realized pill felt hours realized needed taking pills
bravery at the zoo	thought went trip field trip friends played prank pretended put lion cage realized
sick friend	've friend thought call called yesterday did answer began worry know called know friend worry
PERSON buys a phone	living phone decides wants buy goes store choose phone buy buys phone has phone
opening presents	wanted know husband bought birthday started looking house found hiding place had wrapped newspaper opened took peek
ability	had disorder do things school bullied day went counselor told counselor everything happened
brave PERSON	year boy told needs tonsils removed scared surgery becomes brave surgery surgery goes tonsils removed
the miracle	day man death friends carried bed took man called place get friends cut hole roof let man
seasick	cruise see everything became captain gave pills alleviate sickness felt
i , robot	engineering student tried building robot spent months project working tests week has lot work do
chess is no fun	chess game becks liked play family loved games chess time chess match families lost front people do play games
PERSON 's new job !	needed job cutting hair decided ask salon hiring salon manager told hiring qualified candidates got job showing skills
surprise gift	grade school family gave surprise gift birthday go shopping mall stuff want do want buy 's birthday brought nothing got home saw brought hide
the wrong part	sent girlfriend get replacement part car gave model number description said come hours returns managed get part
sprained ankle	had sprained ankle friends going wanted go friends mother bought set crutches join friends
lory the lover	lorry attention dumped fiance went night clubs drank pain control lifestyle collapsed home parents friends gave intervention told stop knew had support needed
bill debacle	will wife had argument bills wife had charge writing sending checks said wanted responsibility month will charge checks passed forgot write send checks
PERSON 's last rodeo	rodeo clown has working job life decides does wan clown puts show quits rodeo clown job begins
sidelines	kia went son soccer game sat bleachers cheer soccer ball flew stands hit kia cheek causing bruise kia decided sit time
replacement fish	gold fish died parents did want tell bought store replaced school found truth
italian restaurant	loved food restaurant moved location found restaurant moved space hoped
PERSON 's new dog	asked father dog had wanted told have pet trained read training dogs weeks preparing care day went store father knew dogs had outsmarted salesman
speeding ticket	running date driving pulled cop knew flirting cops get tickets has date backseat cop car
PERSON 's education	graduated school friends went college did want went trade school learned write computer code leading app developer
ouchless	getting hair tangled went store buy brush found plastic said took home used amazed improvement
the science project	school having science fair entered volcano friend entered volcano won prize vowed work win prize year
dusty room	room did feel cleaning morning throat felt regret cleaning dust cleaned had throat
skip gets a date	skip man looking did know talk women day got courage ask woman date agreed date skip
tree trimming	trimming palm trees street branch fell ground woman passing called warn jumped way branch crashed call
stormy	asked mama asked did know mother clung time cuddled played lot cried had leave
three men rob barbershop	men robbed barbershop yesterday masked men entered shop held patrons gunpoint emptied cash registers took cash jewelry customers fled vehicle driven man
PERSON needs a spare tire	driving interstate way work car began make noises stopped pulling found had tire had removed tire make room truck waits tow truck show tire
coffee bean	citizen likes go get coffee 's food chain gives discount 's going coffee year today got coffee maker home time does have leave house coffee
from the LOCATION	market town go watch people met couple yesterday spoke moment bought sodas bread left stuff bought went way
tree climb	had climbed tree scared climb tried jump tree landed ankle sprained ankle
the renovated shed .	needed work space home noticed shed corner yard condition thought clean weeks work returned shed quality appearance enjoyed work space years come
eating snails	parents walked restaurants grabbed table looked menu shock father ordered snails table snails arrived got tasting taste handle
PERSON 's big win	felt gambling wanted bet money horse did sat watch horse race kens horse beat made lot money
gloomy	feeling recognized warning signs depression went see therapist help therapist kind felt
lemon party	had dream house yard had trees inviting friends had made lemonade everyone loved friends snuck bit went looking did friends had snuck trees begun stealing lemons
ball over the fence	tossing ball yard tossed ball fence ball went neighbor yard climbed fence get ball ball
PERSON finds a watch	evening walking home work notices something laying ground heads look picks notices 's watch takes home keeps
PERSON has no luck	looking date tuesday night decided look internet browsed profiles messaged girls none replied had luck finding date
the egg hunt	family had easter gathering hid eggs kids had surprises kids searched hours fun everyone involved
PERSON 's new puppy	kid house did have pet sleep started feeling mom got puppy puppy sleeps cuddled puppy
neverending	decided watch neverending story searched discs find went netflix tried luck gave went bed
cashier	had go make groceries made budget made list groceries needed went store got everything list got home reviewed grocery bill got surprise discovered cashier overcharged went got money
the christmas parade	time holidazzle christmas parade downtown took kids downtown see parade waved people floats children cheered float drove kids thanked mother told had time
PERSON burns the house	playing matches drops lit starts burn cabinets tries put put fire burns house
bad neighbors	have neighbor ways july neighbor shot fireworks midnight display went nights dog asked neighbor stop noise days man cussed husband challenging fist fight
grateful lady	work bath body works customer wanted purchase product lady upset checked storeroom found box customer help
the pool fight .	swimming pool splashed girl confronted girl girl friends got fight started ended leaving pool
garage party	friends dancing garage having time brought chips dip share kids went home brought snacks danced partied time go
shadow puppets	play shadow puppets suppose sleep stay making kinds shapes mom hated morning school night saw set hands making shapes fear hid covers fell mom tricked
building a sand castle	beach wanted build sand castle created setup tide started coming took pictures destroyed
acting lessons	decided take acting lessons went class teacher did show bunch students waiting turns teacher pretending students impressed acting lesson learned
the dentist lie .	friends planning skipping school wanted join get class decided pretend had dentist appointment note school believed leave problems
the dream	wanted play football grew father began teach game school days think anything school players college star became
the dolphins	family boat going dolphin cruise took saw dolphins chased jumped water took lots pictures animals
the season of giving	had bought coffee coffee shop walked shop noticed man huddled shop looking offered coffee accepted have done something honoring holiday spirit
unfair	brother had power wheel truck wanted brother loved played truck day began despise brother truck decided brother have truck
helping out	lived beach year event put town grandmother went help spent day cleaning beach trash debris grandmother got picture paper
wood wins	kids competing see break block goes takes seconds think punches wood finger broke doctor wrapped bandage
thirsty PERSON	went kitchen get glass water got found did have glasses looked coffee mug drink none drank water bowl
granny 's spaghetti	grandmother makes spaghetti eat love day brought dog visit realized feed dog table bring dog visit grandma
PERSON 's club	wanted start club school found teacher sponsor made fliers advertise club meeting loads people have club
PERSON PERSON falls in love	grew mile tucker cherry farm met boy named skip became friends playing school skip fell love became soulmates
a stuffy office	needed air office basement sunlight decided take walks hours things started feel ended feeling taking walks
the haunted house	visiting aunt house rumored haunted walked living room found ice cold saw fluttering corner eye turned face flutter laughed relief window cracked letting draft blowing drapes
the reel	went movie theater looking job manager said projectionist ticket taker took job projectionist went projection booth start work movie ended people cheered work
constant interruptions	trying tell story friends friend kept interrupting tried play nothing got told friend stop friend apologized did
PERSON 's washing machine	realized something washing machine saw laundry had finished draining decided check owner manual saw said load did have call repairman
trying the water	brothers spent time woods brother made homemade filter tried getting drink water refused siblings tried liked
PERSON visits a rhino	had wanted see rhinoceros saved money trip city zoo zoo saw rhinoceros had imagined got see rhinoceros
lamp purchase	likes read novels apartment has lights reading decided go furniture store get light ended spending lot money reading lamp treasures reading lamp give pleasure
churning ice-cream	week aunt got idea decided make ice cream scratch churned ingredients created recipe everyone family loved
lonely picnic	picnic expecting friend arrive waited hours nobody showed ended eating food brought got car saw friend arrive left
one handed jar opener	lost use hand had trouble opening jars bottles used feet success found device sits counter lets jars device has proven
the dresser	found dresser brought home wanted restore scrubbed put stain looked decided wanted restore pieces house
cereal prize	collecting toys cereal boxes had toys need collection get one bought boxes cereal opened boxes dumping grab toy toys had fell boxes
the deer	sat tree stand looking deer saw cross field fired shot fell loved deer hunting year
treadmill	loves swim used do day gym has time getting pool asked doctor do exercise stay doctor recommended walking treadmill gym gave try loves treadmill
25th wedding anniversary	wedding anniversary took wife honeymoon went train stayed side did got married had time
chocolate	eating chocolates ate deal husband came home work remembered day ate chocolates bought valentine
solemn wedding	dreamed wedding had planned queen regal married had money bought candy bars guests had do
utilities	utilities bill afford decided stop using electricity bought candles bill
prank fail	bed heard someone whispering felt chill run spine turned lamp bed walked closet opened find brother trying scare
a new fish	day watching fish swim tank decided grabbing purse ran car drove petstore petstore had fish chose lady store helped find fish
the wrong date	prom supposed everything going having time danced friends night song came find date dance floor went cool 's saw date making
PERSON plays baseball	going learn play baseball today got baseball gear put baseball uniform fitted mitt dressed go play baseball mom drove baseball practice
bossypants	felt have liked charge decided ask parents sibling parents decided have babysit baby cousin
studying for the test	had forgotten study math exam teacher had sub test postponed relieved studied night test
secrets in a letter .	has working science 's developed equations relating mass energy knows lead weapon feels develop weapon describes ideas letter president
computer problem	bought computer did want turn tried everything fix problem took store found replaced
new ball	ball got stuck roof boy told dad dad got ladder ladder dad got son ball store
carpet scratched	cat devoted wife follows today wife closed door get dressed cat scratched carpet trying get wife said cat obsessed
problem solved	enjoyed going runs went run block wore shoes shoes gave blister took week run owns running shoes wear
PERSON 's late	delivering pizza road runs something gets see hit had hit piece glass delivering pizza car trouble
ice block battle	worked ice warehouse wanted see sit ice sat felt felt time won contest gave
tlr	camera lens bought copy rolleiflex had look camera view subject use camera
broccoli	loves broccoli decided make broccoli cheese grabbed cheese cheese melt dish turned
the disgusting fridge .	had bought fridge online had delivered owner noticed thing opened found mess took hours clean thing
patience	yesterday birthday monday had go school knew had birthday party school excited day got party
sizzle	liked bacon breakfast came breakfast shocked box cheerios counter asked mom did make breakfast told year do
bulk up	trying bulk muscle lifting gym seeing results body read online needs eat calories did noticed results week
little league , big dreams	disappointed did make baseball team brother noticed offered help star athlete had lot tips player time tried chosen team gave brother hug
PERSON 's fence	adopted labrador puppy named loved run day injured hit car had fence installed hospital loved playing yard
not really a gift	mr poke donated millions dollars radio radio station aired news business practices mr poke demanded station stop airing stories station said duty inform public mr poke withdrew support radio
bad credit	hoping get approved auto loan sat banker waiting hear qualify dismay informed credit went home got work fixing credit took year improved credit
you are not alone	sitting country money preparing call mom did want talk dialed cat emerged brush sat lap conversation mother
basketball rim	playing basketball friends jumped dunk ball ended breaking rim came crashing jumped way looked hands awe strength
sunflower seeds	took bag sunflower seeds asking made father allowed do began spilling sunflower seeds spilled sunflower seeds father said sunflower seeds banned house
finally done	grandpa finishing lunch jumped go friends ran car waited grandpa minutes went see taking walked find searching find keys
tasty necklace	students strung colored cereal pieces necklaces let students wear art rest day dismissing class wanted photograph necklaces asked students line picture having eaten cereal necklaces reduced strings
retire	baseball player had game years noticed body giving wondered keep times decided retire
guess	kia had lost measuring cup making casserole needed forced eyeball ingredients had done feared food casserole came
death from diving	man named scared heights friends wanted overcome bought skydiving ticket knowledge had go jumped screamed life survived
the dirt mess	house making dinner son had come playing watched took sweater dirt spilled sweater floor had stop doing
long security wait	yesterday airport had wait security line hour carrying items line dwindled relieved vowed go
the copy	finishing novel nephew boy took book ripped shreds phased had made copy took copy slapped head
tightrope	balanced tightrope concentration heard girl cheering name turned saw girl lost balance tumbled ground caught saw girl laugh leave tent
the hockey game	loved seeing sports played going hockey game did know anything sport excited took friends sat cheered home team
raw oatmeal cookies	making oatmeal cookies put oven set timer minutes timer went opened oven door cookies had forgotten turn oven
no nuts	nuts kind attended grandma party had piece cake hours got rushed hospital having reaction nuts lady cake used nuts frosting
risky riding	liked riding motorcycle friends warned scoffed night skidded hit truck shaken urging needed
blanket head	've girl child used want hair put blanket head ran felt woman 've worn hair
new tattoo	wanted tattoo get decided get star sat flinched started wondering made decision
creepy church	parents made go church thought preacher said decided stop going
new	wanted get bicycle fixed bike technician fixed told buy decided picked bike rode trashed
PERSON plays video games	finds has lot time work decides needs take hobby decides start playing video games finds fun have something do work
lights on	friends trying sneak house left house kitchen light asked do stood doe eyed confused
the girls	had daughters loved spending time girls took shopping day bought lot clothes laughed lot loved making memories girls
purroblem solving	suffered anxiety therapist recommended get cat looked shelters visited adopted cat
PERSON and the toilet	had go bathroom done flushed toilet toilet did overflowed had get plunger unclog toilet unclogged had spend day cleaning water
horror scope	woman dress offered mailman soda declined horoscope had said water today mailman knew soda water knew horoscopes
broken computer	computer running opened screwdriver saw clogged dust blew dust compressed air
lying PERSON	married years told going get gorilla tattoo touched going meet mistress noticed tattoo looked accused cheating lied
vision	started losing eyesight years figure read blackboard teacher scolded taking notes told words called parents had get glasses
the getaway	year took date dinner date flirted year waitress time excused saying had use restroom came waitress got tip
girl shirt	bought shirt goodwill liked way fit wore friends night friends told girl shirt realized did care
first pregnancy	remember pregnancy had morning sickness time co-workers experiencing run comfort room have vomit gave birth 's
the old ipod .	cleaning room cleaning couch discovered ipod had missing years turned found photos friends made smile
building a snowman	kids wanted build snowman rolled balls body had help stack balls top borrowed hat dad closet gave carrot nose finishing touch
amber gets her car fixed	amber drove home work night road flooded drove tow truck had come tow car had go shop get repaired cost boyfriend lot money get fixed
feeling queasy	had eaten dinner stop eating done felt had take ginger tea drank felt
bread oven	wanted make bread yeast grabbed ingredients found needed egg asked neighbor egg yeast neighbor baker had supplies enjoyed home made bread night
PERSON and a bully	bullied school told teacher mother bully got trouble got detention day detention apologized sue mean became friends stopped bullying
grandma 's yarn	person wanted learn knit did have family show did have neighbor called grandma asked grandma teach knit lady taught basics knitting crochet
the needles	knitting had set needles wanted test knit blanket hour decided needles wait see knit
the sneeze	dinner co-workers felt urge sneeze tried muffle bit dinner made pass gas everyone
lucky guest	decided have hamptons house did have wanted take care thought got house felt
coffee here coffee there	'm coffee drinker have 've tried coffee including countries make home go get reason gas station house has coffee 's place choice 'm getting coffee
put them away	had gotten pencil had taken people minutes chasing decided put pencils take put desk left day pencils classroom
backsliding	had broken girlfriend had months hour had year phone week broke day time happened
winning the lottery	bought lottery ticket thought won prize roommate told prank ticket heart broken
keyboard	eats desk boss tells day spilled spaghetti got sauce keyboard keyboard had replaced
stinky shoes	walked home smelled odor looked find source decided clean house get smell done realized odor shoes threw shoes dumpster wore pair
pasta night	did eating pasta family went eat grandmother house mother had cooked spaghetti lied said made sandwich got home
freeway speed	bought sports car wanted see go sped freeway reached mph go
driving experience	driving instructor arrived left house drove house turnpike driving school recommended taking driving test today taking advice consideration signed performed turns passed test
one more	had work assignment do did want do decided bear get done work employer thought
ham	walking street saw man man begged money did give money felt did help day bought ham brought man felt man
the auction	had going auctions months looking furniture day spotted buffet bidding kept going going cave spent fortune piece
two neighbors	neighbors hated decided build wall had see had brick wall erected property hated wall weeks built vandalized wall paint
neighbor	had neighbor widow heard neighbors health began failing hired nurse come day neighbor home visited widow passed spoke memorial service
95 year 's old	year went doctor told drink coffee eat sweets matilda went home poured cup coffee grandson scolded listening doctor year didn
the tooth crack	playing basketball friends someone threw ball right face surprise tooth cracked look dentist fix
strategy	man came strategy moved markers board explained moves soldiers soldiers asked questions man answered
buying a house	weekend fiance visited considering moving year went check houses met realtors enjoyed city decided move time year
tv show	watched episodes cartoon did thought friend like told encouraged watch obsessed cartoon joke dislike allowed find
PERSON learns calculus	finished college years learned calculus decided learn topic borrowed textbook library studied worked learn topics knew calculus
PERSON wins the award	tv actor nominated award arrives award show wins award show goes home award
hot sauce	loved kinds food owned collection sauces ordered food menu day ordered wings restaurant mouth fire days met match
PERSON interview	had job interview position had idea work went shaking walked got job
discomfort	brother had house fought father dad foot pounds felt
friends at the amusement park	went amusement park boys had lot fun water rides go roller coasters rode roller coasters waited ground teased riding rides
professor PERSON	professor liked teacher history church sunday student stood talk professor did remember student worried student offended professor invited church professor asked forgiveness had stroke
christmas decorations	put lot christmas decorations neighbors liked took christmas neighbors started complain decided take
bipolar	friend daughter t came visit week lives tn used live rented car t get day car t cut people argued t found taking meds
PERSON 's talent	wanted singer practiced singer decided try painting had discovered talent gave painting try
tailor PERSON	worked tailor shop summer duties included altering dresses received wedding dress alter worked day night dress make client loved invited wedding
dance it off	excited day wedding day worried realized moment had ordered cake called one fulfill request decided wedding pie have suffice
retired	man retired had nothing do watched television health became died heart attack
my daughter	daughter years has friend friend fight apologize fight
the hand at the window	day work sat chair tv engaged show heard noise looked saw hand resting window glass got grabbed gun walked got window saw hand print person
the purple room	boyfriend color decided color painted bedroom wall violet loved broke rebelled repainting room neon color
virus !	had problem computer took computer repair shop day shop called will told computer loaded viruses had buy computer
dog fight .	walking home store noticed dogs did do started attacking tried breaking fight neighbors pulled dogs
no fish	fishing uncles seemed fish began complaining pole got nibble tried reel caught nothing end did catch anything
candy sick	got lot candy halloween had bags day ate candy got night did stuff
blue stain	day doing laundry got clothes put basket shirt had stain soaked scrubbed wash stain gone
they meet	saw go bathroom friend followed froze saw going pummel brat friend june came saved fight
broken string	went boston symphony orchestra concert guest soloist violinist performance violin string broke everyone waited brought violin crowd applauded end performance
working hard	graduated college lot debt money owed making worry rejected job interviews interviewing walmart bought gun sports section killed trying rob customer service manager
PERSON replaces his stereo	realizes stereo system home getting decides look replacement buys stereo system sale store sets home sounds feels has stereo system home
flower picking	yesterday went flower picking have garden yard went picking picked tulips roses done put vase got compliments flowers
housing crisis	decided buy house market doing meant buy house decided invest money housing market housing market collapsed
inti	do volunteer work profit group called inti group runs soccer art school kids today director sent grant proposal proofread made edits returned proposal hope get grant
new group member	manager introduced employee guys excited did lot favors treated person approached
the bird	playing bird decided perch shoulder excited took picture bird bird flew realized bird defecated shoulder
bb gun	kia classmate pulled gun science class day everyone screamed cowered desks police notified came found bb gun took student evaluation
a man and his horse	came corral horses man road needed sell purchased name muffin muffin came live farm muffin taught bill cherish friends
sand in shoes	returned beach sand shoes stopped porch took shoes dumped sand put hour mother called living room got trouble sand had tracked house
leaving social media behind	had created hit movies signed twitter account had dozens mean messages tweet said going die said movies suck closed twitter account stopped using media panel films fan begged come twitter
PERSON adopts a son	feels have children has met woman wants have kids friend recommends try adopting son adopts son becomes father became father
evicted	lived years fought lot disrupted neighbors neighbors grew fights filed complaints landlord get complaint day months landlord got tired evicted
two PERSONs .	summer camp kids playing get know game partnered someone activity boy introduced bonded name
first dance	remember dance prom night school dance friend do know 'm asked dance night 'm friend ask gave rose
PERSON 's store	wanted buy bread store went store bread gone wanted bread decided open bakery has bread dream
keeping your cool	got home looking homework searched room found baby brother ripping homework pages eating did attack brother threw remains did homework
always late for work	boss yelled work explained caught traffic told fired decided leave get work time
beeping	dreamed beeping looked dream find source woke realized coming microwave
anaphylactic shock	had food allergies eating asked ingredients dish yesterday restaurant served nuts ate nuts realizing went shock result ingesting nuts
sneaky snake	person hated people class stole books classmate threw garbage had friends
joker 's wild	loved playing card game called joker wild decided set joker wild tournament friends friend did want participate tournament friends felt cheated win joker wild disappointed play friends
the sleepover prank .	sister having sleepover friends decided prank waited watching movie jumped scared realized
bugs in the bed	bed sleeping felt tickle arm turned light bug bed called exterminator day
folk music	fan protest songwriting decided research life learned died suffered illness find person
low clearance	driving truck highway paying attention signs failed see sign warned overpass truck clear overpass got fired wrecked truck
PERSON in LOCATION	had wanted live seemed university applied visa go work got job barmaid known friends
sunny day	day couple touring city anniversary 've seen sites taken lots photos day going pizza year couple returns experience
jello	diet craving sweets boiled pot gelatin added poured molds let set fridge jello dessert snacked dessert
PERSON is afraid of storms	had dog named hated storms news issued storm warning evening knew had comfort storm comforted
itchy skin	swimming home felt tried scratch felt found made
PERSON washes dishes	has hosted party feels realizes needs wash dishes begins cleaning plates continues cleaning glasses finished cleaning dishes sleeps day
stone	stone boy loved play football day playing football playground got hurt boy threw football hit face stone glasses got broken got bruise day stone playing football
learning to walk	has lost ability walk breaking legs work doctor told time start walking tried day day get feet walk weeks manage walk door walking work
home late .	friends needed home hanging lost track time got home midnight mom grounded
starwars	matt loved star wars excited see movie went buy tickets sold buy tickets found tickets ground
dvr	show liked record watch way did have watch commercials forgot record show had wait online watch
grandpa passed away	went breakfast speech blurred worker alarmed called ambulance went hospital had stroke passed week
PERSON 's big day	has years wants job has had trouble finding gets interview newspaper works prepare newspaper interview preparation pays offered job
ring	wedding ring fell faucet ring fell reach used plumber took pipes faucet ring retrieve
musical inspiration	attended piano recital parents music inspired learn play piano started taking lessons years held piano recital crowd applauded felt
lazy	habits stopped brushing teeth people work complain got someone offered breath mints took hint brushed teeth
fleet of ships	fleet ships advanced island submarine snuck submarine fired torpedo ships ship exploded ships fleet scattered
adult	man made joke woman called man wanted look started speaking voice made woman respect
setup	band set show drummer find bass drum asked guitarist help went van look base drum sitting van
go for the gold .	had trained swim competition weeks came got vomited turn swim had happened family concerned ended swimming race setting record
bad boat	family bought boat kept running gas made time did know happened boat seem gas sitting fit realized air bubble line did have problems
laundromat	had guinea pigs cage had fleece bedding did want wash bedding house fur went laundromat felt closed day fur dryer vents
two suits	needed get suit wedding deal suits bought decided wear store drove home realized left clothes store called store agreed pick
the rock climbing accident	son went rock climbing weekend fell ground ankle twisted wife rushed hospital had have surgery
PERSON 's new house	bought house moved house week water leak house called plumber plumber fixed leak
cake	depressed grandparents trying cheer attempts made tried wanted left asked grandparents leave locked door
watering the garden	ivy needed water plants turned sprinkler ivy filled watering poured water flowerpot ivy turned sprinkler
new hook	put self hook wall desk home put scratcher shoehorn put jacket hook came tumbling buying nail hook tomorrow
the memorial	family went downtown looked war memorial read names carved stone felt walked home
waiting up	friends mom did set curfew called check told waiting felt situation decided go home time
free throw	played basketball school team missed throws coach recommended practice practiced throws hours scoring game practiced
gain	worked lose pounds began gain stopped gaining worked lose regained weight
polio	sister law brother had polio born baby mother noticed legs kicking took hospital diagnosed polio family moved house had
feeding the birds	loves filling bird feeders home enjoys seeing variety birds attract birds glare window fed fills feeders birds alert friends chirping food supplied loves seeing
the big white dog	wanted have dog decided go pound rescue dog got pound saw dog dog looked eyes knew took dog home
pet ferret	day got pet ferret named whiskers whiskers bonded cuddled lot got
long line at the store	yesterday went clothing store got waiting hour believe line done shopping waiting hours knew go
a heavy weight	has beaten empire president had make decision invade use weapon consulted advisers decided use bomb
bailing his brother out	had brother looked brother kept getting fights school tried keep fighting day got head helped brother resolve conflict fighting
no car for class .	photography class teacher let students go campus take pictures did have car did know anyone class car had take pictures campus
fantasy	library decided look books found absorbed fantasy novel reading did weeks loved reading libraries
my new sister	parents got month birthday sister born child point had changed did seem had sibling
PERSON records another hit	struggling musician had hit people wrote hit wonder wrote song prove everyone song went hit proved everyone
martial arts class	asked father sign mma classes father agreed took day day class junior learned stop asking questions loved practiced hours got home
hiding information	had gotten speeding ticket scared tell parents information published paper parents found citation got trouble telling parents
laundry mishap	needed do load laundry added clothes soap washer minutes heard banging saw bubbles realized had put dish soap laundry soap felt making mistake
lipstick allergy	bought lipstick online manufacturer tried wearing date lips started swell had take lipstick
the missing bike	rode bike school went leave bike gone walked home school told parents bike missing parents called school bike
cupboard	man looked cupboard plates man did dishes put dishes forgot had looking
basketball	thought played game basketball decided challenge friend agreed play practiced days game ended beating points
travel adventure	wanted go vacation go researched vacation spots library talked travel agent trips decided buy tickets
cut foot	broke glass floor did clean glass mom stepped glass foot cut had get stitches hospital
the ladder	fixing bulb took time reach gave ladder changed bulb
storm arrives	storm clouds approaching work building ran car get umbrella get umbrella ran building storm came shut door used umbrella rain left work hour
talk	man talked friend friend expressed frustration man sought help friend friend remained man decided friends temperament
too sour candy	loved candy thought handle day decided buy took home tried threw
let it rip	walking barbed wire fence got pants caught ripped hole friends saw thought cool decided did mind ripped pants
the coffee shop	wanted start business decided coffee shop business researched planned got work open coffee shop got news city had denied permits
PERSON gets glasses	notices see objects thinks need glasses gets pair glasses see see objects
broken fan	had fan needed replaced day started spinning control one blades flew hit forced replace
bakery	owned bakery spent life savings open bakery nobody liked pastries sold bakery failing decided burn bakery see fail
skin	wanted sun tan look put bikini went beach laid sun putting sunscreen fell sun woke hours looking looked lobster
the pergola	working yard built pergola tub wait vines grow going oasis had plans future yard
anger problems	mood work yelled people bus stop screamed bird realized eating pizza felt
outside toys	daugher left toys spread yard warned weather coming did listen warning storm hit blew toys neighborhood crying roaming neighborhood
fake illness	coming addiction felt started affecting job told boss had believed kept job
stuck on the lake	friend took rowboat lake halfway dropped oars stuck way get touch anyone hour boat came girls got rowed boat shore
out the door	time take kids school bundles coats hats remembers forgot lunch rush kitchen throw lunch door go school bond
the uncooked turkey .	thanksgiving day charge turkey food table set checked turkey saw bottom cut pieces served
belated birthday	throwing birthday party friend sent invitations cake one arrived party have started realized wrote time invitations everyone arrived hour
the store in the morning	needed go store husband worked had go everything everything made home
PERSON the vixen	women growing had looks school did care did need coasting looks wanting become model started doing music videos became video vixen time became made school knew
broken cookie	eating milk cookies dipping cookies milk soaked broke half half fell bottom milk glass had use fork get
ruined food	waiter served food family gave place aunt offered salt said poured lot salt food tried eat tasted waiter had throw
the fat man	man ate did care day fatness clogged arteries man had heart attack died tried bury coffin
pressure	bought pressure cooker decided make rice filled cooker rice water left room panicked lid exploded cooker rice had swelled caused explosion
singer	wanted learn sing auditioned sing church choir director said voice tenor learned read sheet music singer joined choir
relaxing at the beach	loved go beach decided spend afternoon beach dug toes sand watched ocean waves spent afternoon relaxing beach
snack time	sat class classmates staring clock snack time waited waited bell rang sprang front room line food
lost contact	changing contact lenses dropped floor looked took time find time got contact lens
seeking a thrill	went spend day fun sun tried rides wanted try roller coaster line waited hour time came sat anticipation ride lasted seconds end exhilarated
cleaning the house	had list chores complete day started sweeping floors mopped kitchen bathrooms wiped surfaces find finished laid couch took nap
PERSON 's allergies	had allergies cleaning house dusted fans baseboards began sneeze had eyes
ice cream day	opened door ice cream parlor knew product wanted saw flavor sparkled case drawn floating display case requested taste test buying ice cream flavor
bartering boys	parents told clean basement going job felt asked friends help hesitated promised play xbox exchange everyone helped playing video games
learning to dance	wanted learn dance college called friend mine teach dancer taught everything knew dancing made dancer
the fleeing dog	took dog walk dog got boy chased dog caught dog leash boy returned dog
two monitors	had lot work do computer had windows had screen space left bought computer monitor monitor allowed
rock climbing fun	dad decided go meet rock wall put harnesses started climbing had ton fun raced dad top ended winning
giving birth	knew baby born felt water break told husband angel angel rushed hospital went labor hours hours baby boy born
PERSON 's visit	feeling wanted see family visit terms family decided father lived visited father felt
cancelled	husband mother asked talk sat porch beer hand began telling childhood abused father numbed warned turn
spectacles	kia had wear glasses day school had forgotten order contacts knowing mocked kids surprise kids did seem care kia relieved had worried nothing
destiny	had friend wanted set date friend said guy day met man coffee shop went date discovered guy got married summer
toddler play time	years toddlers loves play today played rain danced puddles got took shoes went
accuse	sat class got went bathroom came sat noticed pen missing did want accuse pulled
tour of LOCATION	finished reading murder mystery featured lot stores landmarks loved lived years read book toured area see locations got excited news make movie
cleaning the case	needed clean computer case build took rag sink cleaned crevice case dried case hairdryer case used
champion archer	archer ended entering field archery tournament needed bulls eye win tournament managed hit bulls eye won tournament awarded gold medal
starting the car	working car having trouble getting car start brother mechanic got brother come brother got car start
bologna	got bologna sandwiches lunch day complained wife bologna showed images children world put things perspective realized get bologna day
the speaker	noise room speaker blasting rock music tried figure turn get everyone covered ears left room
rude customers	working cashier grocery store customers made fun making money day decided had quit job go school
the yoyo	had toy yoyo wanted learn do lots trips watched youtube videos hour learned do things
the random vacation	friends drinking bar dd says lets go end driving hung beach hours drove
driving with his brother	learning drive brother car brother driving brother thought talking stop light brother got took driving had learn drive someone
grand marnier drink	coworker used drink grand marnier pineapple juice wife looking drink try tonight had grand marnier pineapple juice did find pineapple juice said drink fun
nachos	sue entered nacho eating contest nachos food thought do sue started pace upped ante sue ate pounds nachos did win
choices	wife had decided visit january christmas took surprise give gifts take vacation decided give gifts year
dead motor	husband own boat take boat fishing night sunset decided come motor died had paddle mile shore arrived hours
the purse	wanted buy wife something got print purse opened did like idea ostrich harmed said return
wonder woman costume	wanted wonderwoman halloween went costume shops looking costume shops sold decided make woman costume costume
red sox tickets	wife retiring weeks coworkers found gave wife tickets sox game going son
hot food	decided heat food microwave tossed placed timer minutes minute container splashed place felt burning sensations pain went
bloody nose	work day got nose ran back store grabbed towel cleaning made nose bleeding looked saw line people waiting ran got work
plot twist	woke prepare day school got campus girl greeted introduced commented looks had conversation exchanged numbers addition asked day
broken promise	grade friend made deal agreed have girlfriends hang do guy stuff weeks found had broken agreement found holding hands recess
dark stranger	fell love stranger town strangers invited man move day left man note pick work did arrive did know stranger read
PERSON loves to bake	enjoys baking friends basis decided enter competition fruit judges competition loved fruit won place competition
i 've seen that episode !	woman went twentieth school reunion job having seen lot sitcoms decided doctor did everyone reunion
the wedding announcement	enjoying wedding reception cousins stood began speaking cousin announced earning cheers annoyed cousin stealing attention did want seem did say anything
track star	walking school hallway noticed poster read poster advertised track club meeting image throwing shot put flashed mind decided moment try team had working thought
end of shift	yesterday end work shift cleaning store cleaning noticed woman sitting bench front watched lay bench vomited continued lay bench locked store left
co-worker	hated co-worker got scheduled work co-worker crossed line got fight got fired
the tennis player	tennis player won awards playing tennis clubs school graduate college offered tennis scholarship adam accepted scholarship attended college
calls	kept getting calls seemed pranking got tired blocked number did get calls looked online found 's guy does lot people
hopscotch fun	playing hopscotch sidewalk saw wanted join played til sundown had fun
the sandwich	eating sandwiches left room gone licked sandwich got realized did pay back smeared peanut butter sandwich vowed lick sandwich
the roses	saw van pull house man got handed roses boyfriend called say thank
PERSON 's beach party .	wanted throw beach party friends sat table wrote needed party went stores bought items needed called invited friends wanted party threw beach party had time friends
picking weeds	yard becoming overrun weeds put gloves went picked weeds hours picked weeds yard looked
elephants	loves elephants has wanted see elephant life honeymoon convinces wife go wife travel go tim see elephant
vegan diet	wanted change diet decided vegan cut changing lifestyle
cough drops	came lamented illness stayed home bed developed cough did have medicine called friend asked help friend brought bag lozenges hit spot
fear	doctor appointments had phobia having blood drawn did like shots doctor intimidated does like going doctor
hot water	roommate used take showers leave water use had write note leave counter note asked take showers note takes showers
grey	cloud man decided bring coat began rain man put coat coat protected rain
the bad rental	city work needed rent car get options limited picked rental hated time
the wet phone	wanted take bath bath playing games phone dropped phone bathtub panicked put phone rice rice dried phone use
fishing trip	went fishing trip caught dozen bass caught nothing knew wanted bring fish home family gave fish caught frank have trip invited have dinner family
the dog park	took dog dog park having fun dog started trying attack had intervene took dog home
PERSON 's night out	wanted go birthday went friends club dance night dancing went friends eat had time
morning coffee	mornings drinking coffee lots caffeine helped relax had cups today had coworkers pitched bought
ashram	years wanted find traveled studied ashram studied thought lot wanted end months flew went college did
the scissors	grade sits front class day uses safety scissors cut lock hair school treats incident assault weapon school suspends days
tags	wanted keep dog found knew needed go home owner found dog had tags felt dog knew had find home
ask mac	mac started writing editorial school paper called ask mac students wrote ask things offered advice mac loved writing ask mac
acne	had acne self esteem hated looked mom took dermatologist skin cleared time
the jury	trial jury watched move knew thought tried look jury found
impulse purchase	wife sent get groceries went store got sidetracked wound buying things did need wife upset
PERSON the bragging runner	bragging track runner bragging became friends track team track girls challenged race ended beating race second bragged running
PERSON finds gold	playing front yard trips something looks see digs finds chest gold
watching fireflies	son got excited saw fireflies movie did believe insects light explained country decided take drive find eyes grew one spotted
overflow	oatmeal decided leave kitchen while came minutes overflowed stove left kitchen time cooked oatmeal
the wrong flavor .	grocery store husband asked pick juice bought juice groceries got home checked juice had gotten flavor
a moldy mistake	eve year spilled juice carpet afraid getting trouble covered bean bag chair eve forgot did mom vacuuming moved chair horrified find mold juice spilled
new guitar	wanted take guitar lessons thought gift parents got guitar
hungover	had sampled mom wine night mom had caught grounded morning woke hangover thought punishment grounding vowed drink alcohol
training the new girl	part job train people restaurant today had train hostess phones greeting guests decided cut job fired vowed find job
pothole	house pothole knew hole avoided people did know hit hole called city pothole crews came fixed pothole day
business trip	went business trip got apartment wife found note refrigerator wife had left filed divorce
PERSON make a song	kid loves music starts write words song records song studio made song
new couch	needed move couch home home flights stairs ground enlisted help friends grunting shoving got house did match room decided content
the PERSON family takes a vacation	family has gone vacation years decide go swim surf have time family took vacation
a dodgeball to the face .	playing dodgeball pe had taunting girl team looking threw ball nailed face apologized help laugh bit
shrunken shirt	got t shirt day wore wanted washed decided put washer washed tried dismay shirt had
science	doing science experiment experimenting frog giving drugs see react frog died expected
fake PERSON	asked barbie doll birthday got imitation pals invited play dolls teased doll walked home tossed doll bushes
veteran 's day	wanted do something veteran day went shelter veterans helped feed felt end day
dental work	went root canal dentist said help first had remove tongue rings had had years remove
PERSON picks apples	decides wants try picking apples orchard brings basket collect apples drives orchard orchard picks apples takes apples home eat time went apple picking
more mistakes ?	made mistakes asked help fixing people refused help stopped caring mistakes helped make mistakes
meatloaf	sunday sister-in-law dropped visits talked time left meatloaf gift had meal night
PERSON 's revenge	marriage cheated wanted revenge put sugar tank slashed tires divorced day
a girl and her fern	begged mom puppy mom gave fern mom said took care fern get dog forgot water fern week has practice responsibility cactus notice
the very big reunion	bit going school reunion feared group girls made fun put brave face neared reception hall relieved discover girls had gotten fat fat made girls had time
being too hasty	family came aunt house played hide go seek turn look everyone looked shower curtain pulled curtains ended pulling sister hair
not a phone	wanted phone christmas anything unwrapped iphone box opened find silver bracelet mother had trying trick box had christmas
first snow	snowflake drifted sky ground saw happen window went collect flake found waited flake arrive
director	actor play rehearsal forgot lines looked stage director worry director gave look felt had studied lines
milestone	friend asked hang became puts work inconvenience see did hesitate say 've said past understood left end remained friends
winter storm	did snow did expect blizzard pipes froze burst blizzard one get fix water flooded basement prayed blizzard did
follow the rainbow	pilot flying plane rain storm saw rainbow decided see ended rainbow became followed did give end rainbow parking lot cleaners pilot disappointed did have end
the bad product	looking socks online found pair reviews decided risk quality disappointment socks quality left review socks online
drinking challenge	considered drinker bar night stranger challenged drinking challenge accepted won got ego drinking problem
summer body	winter shape wanted get shape summer started working eating time got looked got compliments
salads	went doctor doctor told decided do something started bringing salads work eating sandwiches month had lost pounds
not as long as he thought	friend had go jail days given midnight turn dropped night called come pick hours days
sight	born eye age doctors said give eye sight had tissue donation eye operation terrified waking depth perception feeling life
sports bar	loved watching sports sports bars decided get tray wings watch season game showed bar day had used season schedule days
girlfriend	girls mystery tried make bought flowers chocolates found girl appreciated became girlfriend boyfriend result
the smelly house	rich came home vacation horrified reason house smelled wandered looking source smell found gallon milk table opened windows dissipate smell
salt	went school learned flavors home made chicken soup family played kinds seasonings spices soup did taste right mom added salt soup became
new stereo system	going cruise friends had gotten brand stereo system car played tunes blast got pulled police police officer gave warning playing music
improving the memory	year takes partner place moving book flights place met place bar moved year arrived find place shut star restaurant worked
dollar menu	afternoon nothing eat house had money started looking change couch cushions get change dollar menu
tree man	day man climbed tree police called man refused get tree waited hours man came tired
catching a cold	felt getting afford miss days work decided go work kept getting cold blown went work got people
PERSON rescues the cat	walking street day sees cat stuck tree tries call cat does come climbs tree rescues cat
magazine party	had night had attend magazine party got hair makeup done walked tripped dress fall
zen	enjoyed meditation wanted reach states meditation had heard zen learned learned zen applied techniques improved meditation
PERSON and the computer	liked working computers started business working computers accepted work started overwhelmed work hired person help finish computers
baroque music	went study recorder came banded group friends played music became sensation milieu
PERSON gets rescued	going work has take elevator car elevator stops working calls help firemen rescue ted elevator
no shaving	decided stop shaving figured having beard trouble work did forced go shaving
dead as a duck	aunt bought brother ducklings easter kids see play day hurried aunt house play arrival realized ants lesson pet death
money matters	mom lived time wanted talk had pay money did call mother died paid thousands dollars take plane regretted having spent dollars talk
PERSON and her doll	had collection dolls bedroom had doll called day school pet dog skippy found skippy chewed arms devastated finding chewed doll
faker	went diner ordered breakfast decaf coffee server looked poured coffee sipped coffee knew gave coffee came food called server hung head shame gave tip
the opera	had opera excited see happen arrived opera house date took seat show began believe sounded
sand in the car	going vacation taking family beach had time spent lot time sand family returned home had clean sand car
rainy	loved everything rainy liked smell sound lived west coast city summer visited got desire
the wingman	friend friend met girl girl had friend wanted hang hung friend help
the sandwich	made sandwich eat had knock door put sandwich coffee table forgot dog roaming came dog had eaten sandwich
good service	waiting restaurant server made drinks brought ticket dinner gave tip
the aroma	date showered wanted smell cologne made cover part date turned broke hives had go
PERSON buys a dress	girl did have clothes nothing fit well went mall found salesperson salesperson picked dress fit decided buy
snowboarding	friend ate burger had feeling stomach eating hours fell went doctor cure illness doctor gave antibiotics get
calls	kept getting calls people calls came hours night day changed number problem stopped gives number felt loved received calls
snack attack	sat bag popcorn turned tv ate handful tried find something watch found tv show watch looked bag
stolen jacket	arrived work macy put coat room wanted go break went grab coat surprise coat gone informed management coat taken area coat found offered replace
pretty	thought whenever friends dress visiting mall friends spotted agent agent turned recruiter modeling company working model brand
bite	walking saw straw cat decided pet cat bit got went doctors
brothers	closed door waited snuck jumped corner terrified caused tackle tickle cried love thing
the suitcases	hated lugging suitcases storage trip had luggage room built house loved having designated spot luggage pack retrieve bags room made organized
running man or dog	day took dog park walk walking runner runs going sprinted chase runner chased minutes caught sat tree enjoyed shade run
suprise	today birthday woke bed decided make breakfast heard knocks doors got seat walked door opened door family front
friday night basketball	friday night friends play basketball friday went gym play ball lot people showed did know got know playing have lot friends play basketball
bikini blues	wanted bikini bring summer camp mom tried coax get one-piece prevailed packed bikini camp lake thrilled girl bikini diving platform saw made sense
PERSON tries to skateboard	friends love skateboard has tried learn months made progress decided skateboarding
the sandals	girl hated wearing shoes wear sandals time go school insisted wear sandals had sandals feet mom threw sandals sleeping
the couch	noticed tear material couch went store bought needle thread sewed material couch shut days tear reopened brought couch upholsterer
piano practice	wanted learn play piano start practiced school improved deal play song likes
fabric	woman cut fabric made pattern found pattern fabric cut fabric pattern
waffles	bought waffle maker filled batter pressed sides waited had waffle ate found
bartender school	wanted learn bartender enrolled class community college showed hours class knowing expect ends having time learned make lots drinks makes drinks friends has
PERSON likes soup	soup chicken soup 's kind soup eat day tries tomato soup tomato soup becomes soup decides try things
little girl lost	years had cabbage patch wheels rode street day day rode way end road man truck hit pulled took home got house yelled aunt watching
starfish	walked beach house beach wanted watch sunset way stepped starfish picked starfish threw enjoyed sunset felt had done
a glass of wine	did like drink alcohol circumstances excused events include alcohol evening girlfriend offered glass wine decided drink beverage hoping like wine change mind
plant	wanted liven apartment bought plant watered day watered plant died
lost dog	lost dog meant world put posters offered reward stranger called number told found had hit dog car killed
cable issues	amber turned television noticed cable working called company told outage amber went store bought antenna installed television amber watch channels issues
doughnut	wife bought dd artisan doughnuts supposed have filling mine did have filling going complain gave doughnut tasted ok
fat child	grade school saw girl school bully day decided talk offer sit canteen became friends one expected
the roller skating accident	loved roller skate did know shared interest decided go rollerskating block time surprise crashed rounded corner apologize became friends incident
the broken guitar	getting show band helping carry equipment stage tripped dropped guitar neck snapped leaving show someone find replacement time
board games	playing board games family losing ran room crying mother went comfort realized having family made winner
married	getting married sweating husband saw walk aisle nerves gone said do kissed
floss stick	went eat night piece meat got stuck teeth have plate did want take public waited got home use floss stick taking piece meat brought relief
PERSON gets a new job	laid job picked paper looked help wanted ads sent resumes companies got interview companies got job interviewed
blood drive	went employer blood drive volunteer gave forms fill turned forms lab tech set donation sat chair donated blood done staff member gave cookie juice
daydreaming	pay attention class wandered mind thinking fantasies nonsense medicated does class does fantasize
book report speech	had give speech book report speech had incorporate prop book dad helped make cardboard plastic diving helmet speech stuttering got marks speech credit prop
late again	woke work morning rush get left watch nightstand arrived work boss asked knew did have watch told did know
exhausted	exhausted soccer practice needed finish homework estimated take hours began work found nose desk
night	night nurse called doctor doctor said baby distress pitocin drip stopped left lying night doctor coming help
close to death	made turn highway floors car fell course jumped barriers grass suffered headache get towing service took car
sick neighbor	lived door woman had seen woman days walked door visit neighbor found visited everyday recovered
PERSON 's road trip .	waiting paycheck come vacation state road trip covering ca or excited check came packed bags met friends drove states saw attractions adding joy end trip felt fulfilled work
the soccer injury .	soccer player middle game foot slid grass twisted ankle fell pain parents had take doctor
pokemon hunting	waking brushed teeth did basics turned pokemon go made breakfast shocked charizard neighborhood throw food run door go run direction searching hunt begins set hopes finding
the stuffed puppy	had stuffed puppy day mother went post office put puppy mailbox mother looking started screaming mailman got puppy
on the road	family went road trip piled car snacks tow car broke mechanic fixed car sent way smith hit road found energy
heights	went wanted ride train closed day repairs decided try pirate ship ended having lot fun conquering fear heights
playing in the bathroom	playing bathroom flushed toilet paper toilet toilet got stopped began overflow got trouble stopping toilet
big shot	town woods year day man came offered buy town people excited had struggling deal concluded man killed town ruined
budget	mom gave school clothes went mall excited saw clothes realized afford mall clothes had go shopping department store
driving a car	learning drive time tried crashed thought learn practiced ended passing driving test flying colors
basketball game	had basketball game tonight team felt team ended winning game relieved
video rivals	has lost video game day gets challenged puts fight utilizes skills potential ends winning
lost coins	going do laundry find quarters asked roommate admitted used arcade made pay
beginner	wanted learn sing signed group singing class exercises realized tune teacher coached gave encouragement let go self-consciousness improved
