house had bunch termites started noticing bugs wood work crumbling called agency come check told had fumigate house	PERSON 's house had a bunch of termites . She started noticing small bugs everywhere . Her wood work was crumbling a little . She called an agency to come check it out . They told her she had to fumigate the whole house .
felt something crawling leg saw bug jumped swatted bug scurried couch stood table someone come smash bug	PERSON felt something crawling across her leg . She saw a huge bug ! She jumped up and swatted at it . The bug scurried under her couch . PERSON stood on the table until someone could come smash the bug .
had seen play performed go girlfriend asked performance thought tickets saw play liked do planned go	PERSON had never seen a play performed live before . He was reluctant to go when his girlfriend asked him to a performance . He thought the tickets were too expensive and it would be boring . But when they saw the play , PERSON was surprised how much he liked it . It was too expensive to do often , but he planned to go sometimes .
had dream everyone loved woke made goal make dream come	PERSON had a dream . It was about him being famous . Everyone loved him . Then he woke up . He made it his goal to make the dream come true .
wants try painting nails color looks nail polish decides paints nail 's done nails look nail color	PERSON wants to try painting her nails a new color . She looks at all of her nail polish and decides on black . PERSON paints each nail very carefully . When she 's done , her nails all look great . PERSON is very happy with her new nail color .
textbook went missing tried look laundry room dust flying desk managed find book bin blister broke mouth	My textbook went missing . I tried to look inside the laundry room . Dust was flying everywhere , especially on the desk . I managed to find the book inside a bin . However , a blister broke out on my mouth .
chewing gum glass girl sat asked stop chewing chewed gum hearing ended fighting	PERSON was chewing gum in glass . The girl who sat next to her was furious . She asked PERSON to stop chewing . PERSON chewed her gum harder after hearing her . They ended up fighting each other .
trying sleep pillow annoyed sleep decided sleep pillow woke neck ache	PERSON was trying to sleep . The pillow was too big . It annoyed him so much he could n't sleep . He decided to sleep without the pillow . He woke up with a neck ache .
had take pill swallowed realized pill felt hours realized needed taking pills	I had to take a pill . I swallowed it . I realized it was the wrong pill . I felt sick for a few hours . I realized I needed to be more careful about taking pills .
thought went trip field trip friends played prank pretended put lion cage realized	PERSON thought he was tough . He went to the trip on a field trip . His friends played a prank on him . They pretended to put him in the lion 's cage . PERSON realized how not tough he was .
've friend thought call called yesterday did answer began worry know called know friend worry	I 've a friend who is pretty ill so I thought it best to call him . I called him over and over yesterday but he did n't answer . So I began to worry . Then would n't you know it he called me ! So now I know my friend is OK and so I wo n't worry any more .
living phone decides wants buy goes store choose phone buy buys phone has phone	PERSON is sick of living without a phone . He decides he wants to buy one . PERSON goes to the store to choose which phone to buy . He buys a cheap but nice phone . PERSON is happy that he finally has a phone .
wanted know husband bought birthday started looking house found hiding place had wrapped newspaper opened took peek	PERSON wanted to know what her husband bought her for her birthday . She started looking around the house . She finally found his hiding place . He had wrapped her present in newspaper . She carefully opened it and took a peek .
had disorder do things school bullied day went counselor told counselor everything happened	PERSON had a disorder . she was n't able to do many things . Everyday at school she was bullied . One day she went to a counselor . She told the counselor everything that happened .
year boy told needs tonsils removed scared surgery becomes brave surgery surgery goes tonsils removed	PERSON is a 10 year old boy . He is told he needs his tonsils removed . PERSON is scared of surgery . PERSON becomes brave and is ready for surgery . The surgery goes well and PERSON 's tonsils are removed .
day man death friends carried bed took man called place get friends cut hole roof let man	One day a man was sick to death . His friends carried him with his bed . They took to a man called PERSON . The place was so crowded they could not get to PERSON . His friends cut a hole in the roof and let the sick man down .
cruise see everything became captain gave pills alleviate sickness felt	PERSON was on her first cruise . She was so excited to see everything ! But then she became very , very nauseous . The captain gave her some pills to alleviate the sickness . Soon , PERSON felt much better .
engineering student tried building robot spent months project working tests week has lot work do	PERSON is a senior engineering student . He recently tried building his own robot . PERSON spent months on the project , working on and off . His initial tests were last week . Unfortunately , he still has a lot of work to do .
chess game becks liked play family loved games chess time chess match families lost front people do play games	Chess was not a game the Becks liked to play . They were a family that loved games , all but chess . One time they were at a chess match with other families . And they lost horribly in front of many people . They do n't play games anymore .
needed job cutting hair decided ask salon hiring salon manager told hiring qualified candidates got job showing skills	PERSON needed a job that she was good at . She was good at cutting hair . She decided to ask the salon if they were hiring . The salon manager told her they were hiring to qualified candidates ! PERSON got the job after showing off her skills !
grade school family gave surprise gift birthday go shopping mall stuff want do want buy 's birthday brought nothing got home saw brought hide	I was in grade school when my family gave me surprise gift . It was my birthday when we go the shopping mall . All stuff that i want was there but they do n't want to buy it . I was so sad because it 's my birthday and they brought nothing for me . But when we got home i saw they all brought it but they just hide it .
sent girlfriend get replacement part car gave model number description said come hours returns managed get part	I sent my girlfriend to get a replacement part for my car . I gave her the model number and a description . She said she would come right back . Three hours later she finally returns . Somehow she still managed to get the wrong part .
had sprained ankle friends going wanted go friends mother bought set crutches join friends	PERSON had sprained her ankle . Her friends were going to the fair . PERSON wanted to go to the fair with her friends . Her mother bought her a set of crutches . PERSON was able to join her friends at the fair .
lorry attention dumped fiance went night clubs drank pain control lifestyle collapsed home parents friends gave intervention told stop knew had support needed	Lorry was desperate for attention she was just dumped by her fiance . She went out every night to different clubs and drank away the pain . When she could n't control this lifestyle anymore she collapsed at home . Her parents and friends gave her an intervention and told her to stop . She knew they were right and that she had all the support she needed .
will wife had argument bills wife had charge writing sending checks said wanted responsibility month will charge checks passed forgot write send checks	Will and his wife had an argument about the bills . His wife had always been in charge of writing and sending the checks . PERSON said he really wanted that responsibility . The first month with Will in charge of the checks passed by . Will forgot to write and send the checks !
rodeo clown has working job life decides does wan clown puts show quits rodeo clown job begins	PERSON is a rodeo clown . He has been working the job all his life . He decides he does n't wan na be a clown anymore . He puts on one last show . PERSON quits his rodeo clown job and begins a new one .
kia went son soccer game sat bleachers cheer soccer ball flew stands hit kia cheek causing bruise kia decided sit time	Kia went to her son 's soccer game . She sat in the bleachers to cheer him on . But then a soccer ball flew into the stands ! It hit Kia in the cheek , causing a big bruise . Kia decided to sit farther back next time !
gold fish died parents did want tell bought store replaced school found truth	PERSON 's gold fish died overnight . His parents did n't want to tell him . They bought a new one at the store . They replaced it while PERSON was at school . He never found out the truth .
loved food restaurant moved location found restaurant moved space hoped	The PERSON 's loved Italian food . Their favorite Italian restaurant moved to a new location . They were very disappointed . Then they found out a new Italian restaurant moved into the space . They hoped that maybe it would be their new favorite !
asked father dog had wanted told have pet trained read training dogs weeks preparing care day went store father knew dogs had outsmarted salesman	PERSON asked her father for a dog , as she had always wanted one . He told her she could only have a pet if she trained it . PERSON read about training dogs for weeks , preparing to care for it . On the day they went to the store , her father was quite pleased . PERSON knew so much about dogs now , she had outsmarted the salesman !
running date driving pulled cop knew flirting cops get tickets has date backseat cop car	PERSON was running late for a date . So he was driving 60 in a 30 . Instantly he was pulled over by a cop . PERSON always knew flirting with cops could get out of tickets . He now has a date with the backseat of a cop car .
graduated school friends went college did want went trade school learned write computer code leading app developer	PERSON graduated from high school . PERSON 's friends mostly went to college but he did n't want that . PERSON went to a trade school . There , PERSON learned how to write computer code . Now PERSON is a leading mobile app developer .
getting hair tangled went store buy brush found plastic said took home used amazed improvement	I was sick of getting my hair tangled . I went to the store to buy a new brush . I found a pink plastic one . It said it was ouchless . I took it home and used it , amazed at the improvement .
school having science fair entered volcano friend entered volcano won prize vowed work win prize year	PERSON 's school was having a science fair . PERSON entered his volcano into the fair . PERSON 's friend , PERSON , entered a bigger and better volcano . PERSON won first prize . PERSON vowed to work harder to win the prize next year .
room did feel cleaning morning throat felt regret cleaning dust cleaned had throat	PERSON 's room was very dusty . But he did n't feel like cleaning it . One morning , his throat felt very sore . And he regret not cleaning up the dust . So he cleaned it up immediately and never had a sore throat again .
skip man looking did know talk women day got courage ask woman date agreed date skip	Skip was a lonely young man . He was n't bad looking at all . He just did n't know how to talk to women . One day he got the courage to ask a woman out on a date . She agreed to the date with Skip .
trimming palm trees street branch fell ground woman passing called warn jumped way branch crashed call	PERSON was trimming palm trees along the street . A big branch fell to the ground just as a young woman was passing . PERSON called out to warn her . She jumped out of the way just as the branch crashed down . It was a very close call .
asked mama asked did know mother clung time cuddled played lot cried had leave	Stormy asked if I could be her new mama . She asked because she was little and did n't know who her mother was . She clung to me the whole time I was there . I cuddled her and played with her a lot . I cried when I had to leave her .
men robbed barbershop yesterday masked men entered shop held patrons gunpoint emptied cash registers took cash jewelry customers fled vehicle driven man	Three men robbed a local barbershop yesterday . Two masked men entered the shop and held patrons at gunpoint . One of them emptied all the cash registers . The other took cash and jewelry from customers . The two then fled in a vehicle driven by a third man .
driving interstate way work car began make noises stopped pulling found had tire had removed tire make room truck waits tow truck show tire	PERSON was driving down the interstate on his way to work . His car began to make noises , so he stopped . After pulling over , he found he had a flat tire . PERSON had removed his spare tire to make room in his truck . He now waits for a tow truck to show up with a spare tire .
citizen likes go get coffee 's food chain gives discount 's going coffee year today got coffee maker home time does have leave house coffee	PERSON is a senior citizen and likes to go out to get coffee . There 's a fast food chain that gives him a senior discount . He 's been going there for coffee for twenty Year 's . Today he got a coffee maker for his home for the first time ever . Now he does n't have to leave his house for coffee .
market town go watch people met couple yesterday spoke moment bought sodas bread left stuff bought went way	Our only market in town is very , very small . But sometimes I just go there just to watch to the people . I met a couple there yesterday who were from the LOCATION We spoke for a moment and then they bought some sodas and bread . Then they left with the stuff they bought and went on their way .
had climbed tree scared climb tried jump tree landed ankle sprained ankle	PERSON had climbed into a tree . He was scared to climb down . PERSON tried to jump out of the tree . He landed hard on his ankle . PERSON sprained his ankle .
needed work space home noticed shed corner yard condition thought clean weeks work returned shed quality appearance enjoyed work space years come	PERSON needed some work space in his crowded home . He noticed an old dirty shed in the corner of the yard . It was in bad condition but he thought he could clean it up . Several weeks of hard work returned the shed to a quality appearance . PERSON enjoyed his private work space for years to come .
parents walked restaurants grabbed table looked menu shock father ordered snails table snails arrived got tasting taste handle	PERSON and her parents walked into one of the nicest French restaurants . The three of them grabbed a table and looked at the nice menu . To her shock , PERSON 's father ordered some snails for the table . When the snails arrived , PERSON nearly got sick tasting them . The taste was too much for her to handle .
felt gambling wanted bet money horse did sat watch horse race kens horse beat made lot money	PERSON felt like gambling . He wanted to bet all his money on a horse . That is exactly what he did . He sat down to watch the horse race . Kens horse beat them all and made him a lot of money .
feeling recognized warning signs depression went see therapist help therapist kind felt	PERSON was feeling very gloomy . She recognized warning signs of depression . Thus , she went to see a therapist to help her . The therapist was kind to her , and friendly . PERSON soon felt better once again .
had dream house yard had trees inviting friends had made lemonade everyone loved friends snuck bit went looking did friends had snuck trees begun stealing lemons	PERSON had her dream house , and in the yard she had some lemon trees . Inviting her friends over , she had made fresh lemonade . Everyone loved it however two of her friends snuck away for a bit . LOCATION went around looking for them , and finally she did . Her two friends had snuck to the trees , and begun stealing lemons .
tossing ball yard tossed ball fence ball went neighbor yard climbed fence get ball ball	PERSON and PERSON were tossing a ball around in the back yard . PERSON accidentally tossed the ball over the fence . The ball went into the neighbor 's yard . PERSON climbed over the fence to get the ball . PERSON was more careful with the ball after that .
evening walking home work notices something laying ground heads look picks notices 's watch takes home keeps	One evening while walking home from work . PERSON notices something laying on the ground . He heads over to look at what it is . He picks it up and notices it 's a very expensive watch . PERSON takes it home and keeps it for himself .
looking date tuesday night decided look internet browsed profiles messaged girls none replied had luck finding date	PERSON is looking for a date Tuesday night . He decided to look for one on the internet . He browsed several profiles and messaged a few girls . None replied back to him . PERSON had no luck finding a date .
family had easter gathering hid eggs kids had surprises kids searched hours fun everyone involved	PERSON 's family had an Easter gathering . They hid eggs for all the kids . Some of them had surprises in them . The kids searched for several hours . It was great fun for everyone involved .
kid house did have pet sleep started feeling mom got puppy puppy sleeps cuddled puppy	PERSON was the only kid in the house did n't have a pet to sleep with . PERSON started feeling sad and lonely . Her mom got PERSON a little puppy . PERSON was very happy about her new puppy . PERSON now sleeps cuddled up next to her puppy .
decided watch neverending story searched discs find went netflix tried luck gave went bed	We decided to watch The Neverending Story . We searched our discs but could n't find it . We went to netflix and it was n't there either . We then tried LOCATION with no luck . Eventually we gave up and went to bed .
had go make groceries made budget made list groceries needed went store got everything list got home reviewed grocery bill got surprise discovered cashier overcharged went got money	I had to go make groceries so I made a budget . I also made a list of the groceries I needed . I went to the store and got everything on my list . When I got home I reviewed my grocery bill and got a surprise . I discovered the cashier overcharged me and went back and got my money .
time holidazzle christmas parade downtown took kids downtown see parade waved people floats children cheered float drove kids thanked mother told had time	It was time for the Holidazzle Christmas Parade downtown . PERSON took her kids downtown to see the parade . They waved to all the people on the floats . The children cheered when the final float with LOCATION drove by . The kids thanked their mother and told her they had a great time .
playing matches drops lit starts burn cabinets tries put put fire burns house	PERSON is playing with matches . He accidentally drops a lit one . It starts to burn the cabinets . PERSON tries to put it out . PERSON can not put out the fire and burns the house down .
have neighbor ways july neighbor shot fireworks midnight display went nights dog asked neighbor stop noise days man cussed husband challenging fist fight	We have a neighbor that is extremely annoying in many ways . Last 4th of July , this neighbor shot off fireworks until midnight . This loud display went on for three nights , terrifying our dog . We politely asked our neighbor to stop the noise 3 days after the 4th . The man cussed out my husband , challenging him to a fist fight .
work bath body works customer wanted purchase product lady upset checked storeroom found box customer help	PERSON was at work at Bath And Body Works . A customer wanted to purchase 50 of one particular product . The lady was upset there were only 10 available . PERSON checked in the storeroom and found a new box . The customer was very grateful for all of PERSON 's help .
swimming pool splashed girl confronted girl girl friends got fight started ended leaving pool	PERSON was swimming at the local pool . Suddenly she was splashed by a random girl . She confronted the girl . The girl and her friends got mad and a fight started . PERSON ended up leaving the pool .
friends dancing garage having time brought chips dip share kids went home brought snacks danced partied time go	PERSON and her friends were dancing in the garage . They were having a great time . PERSON brought chips and dip out to share . Other kids went home and brought other snacks . They danced and partied until it was time to go inside .
play shadow puppets suppose sleep stay making kinds shapes mom hated morning school night saw set hands making shapes fear hid covers fell mom tricked	PERSON would always play shadow puppets when he was suppose to sleep . He would stay up so late making all kinds of shapes . His mom hated how tired he was every morning before school . One night PERSON saw another set of hands making shapes . In fear he hid under the covers and fell asleep , his mom tricked him .
beach wanted build sand castle created setup tide started coming took pictures destroyed	PERSON was at the beach . He wanted to build a sand castle . He created a very elaborate setup . After a while the tide started coming in . PERSON took pictures of it before it was destroyed .
decided take acting lessons went class teacher did show bunch students waiting turns teacher pretending students impressed acting lesson learned	I decided to take acting lessons . When I went to the class , the teacher did n't show up . It was only a bunch of students waiting . It turns out the teacher was pretending to be one of the students . We were all impressed with the wonderful acting lesson we learned .
friends planning skipping school wanted join get class decided pretend had dentist appointment note school believed leave problems	PERSON 's friends were all planning on skipping school . She wanted to join them but it was hard to get out of class . She decided to pretend she had a dentist 's appointment . With a fake note , the school believed her . She was able to leave with no problems .
wanted play football grew father began teach game school days think anything school players college star became	PERSON wanted to play football when he grew up . When he was old enough , his father began to teach him the game . All throughout his school days , PERSON could not think of anything else . When he was in high school , PERSON was one of the best players . In college , he was a star and afterwards , he became a professional !
family boat going dolphin cruise took saw dolphins chased jumped water took lots pictures animals	The family was on a boat . They were going on a dolphin cruise . As soon as they took off , they saw several of them ! The dolphins chased them and jumped out of the water . They took lots of pictures of the animals .
had bought coffee coffee shop walked shop noticed man huddled shop looking offered coffee accepted have done something honoring holiday spirit	PERSON had just bought a holiday-themed coffee from the coffee shop . As she walked out of the shop , she noticed a homeless man . He was huddled next to the shop looking very cold . PERSON offered him the coffee and he graciously accepted . PERSON was glad to have done something honoring the true holiday spirit .
brother had power wheel truck wanted brother loved played truck day began despise brother truck decided brother have truck	PERSON 's brother PERSON had a Power Wheel truck . PERSON always wanted one but was too old . His brother loved and played with the truck all day . PERSON began to despise his brother and his new truck . PERSON decided it was n't fair for his brother to have a truck .
lived beach year event put town grandmother went help spent day cleaning beach trash debris grandmother got picture paper	PERSON lived near the beach . Every year there was a clean up event put on by the town . PERSON and his grandmother went down to help out . They spent the day cleaning the beach of trash and debris . PERSON and his grandmother even got their picture in the paper !
kids competing see break block goes takes seconds think punches wood finger broke doctor wrapped bandage	The kids are competing to see who can break the wooden block . PERSON goes first . She takes a few seconds to think . Once she punches the wood , her middle finger broke . The doctor wrapped it with a bandage .
went kitchen get glass water got found did have glasses looked coffee mug drink none drank water bowl	PERSON was very thirsty . She went to her kitchen to get a glass of water . When she got there she found that she did n't have any clean glasses . She looked for a coffee mug to drink out of , but there were none . Eventually PERSON just drank water out of a bowl .
grandmother makes spaghetti eat love day brought dog visit realized feed dog table bring dog visit grandma	My grandmother makes the worst spaghetti ever . I usually just eat it because I love her . One day I brought my dog over to visit her with me . I realized I could feed the dog under the table . Now I bring my dog to every visit with grandma .
wanted start club school found teacher sponsor made fliers advertise club meeting loads people have club	PERSON wanted to start a comic club at her school . She found a teacher sponsor . She made fliers to advertise the club . At the first meeting , there were loads of people who were interested . Now they have a great club .
grew mile tucker cherry farm met boy named skip became friends playing school skip fell love became soulmates	PERSON PERSON grew up in LOCATION . Just a mile from tucker cherry 's farm . She met a boy Named Skip . The two became best friends playing after school . PERSON PERSON and Skip fell in love and became soulmates .
needed air office basement sunlight decided take walks hours things started feel ended feeling taking walks	PERSON needed some fresh air . Her office with in the basement with no sunlight . She decided to take walks outside every few hours . Things started to feel less stuffy . She ended up feeling much better after taking walks .
visiting aunt house rumored haunted walked living room found ice cold saw fluttering corner eye turned face flutter laughed relief window cracked letting draft blowing drapes	I was visiting my aunt 's house which was rumored to be haunted . I was afraid when I walked into the living room and found it ice cold . Even scarier , I saw a white fluttering out of the corner of my eye . I turned to face the ghostly flutter and laughed out loud in relief . A window was cracked open , letting in a draft and blowing the drapes .
went movie theater looking job manager said projectionist ticket taker took job projectionist went projection booth start work movie ended people cheered work	PERSON went to the movie theater looking for a job . The manager said he could either be a projectionist or ticket taker . PERSON took the job of projectionist . He went to the projection booth to start work right away . After the movie ended , the people cheered for PERSON 's great work .
trying tell story friends friend kept interrupting tried play nothing got told friend stop friend apologized did	PERSON was trying to tell a story to friends . One friend kept interrupting . PERSON tried to play it off as nothing at first . After a while he got annoyed and told his friend to stop . PERSON 's friend apologized and did so .
realized something washing machine saw laundry had finished draining decided check owner manual saw said load did have call repairman	PERSON realized something was wrong with her washing machine . She saw that the laundry had n't finished draining . PERSON decided to check her owner 's manual . She saw that it said that it might be an uneven load . PERSON was glad that she did n't have to call a repairman .
brothers spent time woods brother made homemade filter tried getting drink water refused siblings tried liked	PERSON and her brothers spent time in the woods . Her older brother made a homemade filter . He tried getting them to all drink the water . PERSON refused because she was n't sure it was really clean . But her other siblings tried it and liked it .
had wanted see rhinoceros saved money trip city zoo zoo saw rhinoceros had imagined got see rhinoceros	PERSON had always wanted to see a rhinoceros . She saved up her money for a big trip to the city zoo . At the zoo she saw a huge rhinoceros . It was much bigger than she had ever imagined it would be . PERSON was so happy she got to see a rhinoceros .
likes read novels apartment has lights reading decided go furniture store get light ended spending lot money reading lamp treasures reading lamp give pleasure	PERSON likes to read novels . Her apartment has very dim lights that are not good for reading . PERSON decided to go to a furniture store to get a proper light . She ended up spending a lot of money on a reading lamp . PERSON now treasures her reading lamp as it give her pleasure .
week aunt got idea decided make ice cream scratch churned ingredients created recipe everyone family loved	Last week my aunt got an interesting idea . She decided to make ice cream from scratch . She churned the ingredients herself and created a new recipe . It was delicious . Everyone in the family really loved it .
picnic expecting friend arrive waited hours nobody showed ended eating food brought got car saw friend arrive left	PERSON was at a picnic . And he expecting his friend to arrive . He waited for hours , but nobody showed up . And he ended eating all the food he brought by himself . When PERSON got into his car , he saw his friend arrive but left anyway .
lost use hand had trouble opening jars bottles used feet success found device sits counter lets jars device has proven	I lost use of my left hand in 2011 . I had trouble opening jars and bottles . I used my feet with limited success . I found a device that sits on the counter and lets me open jars . This device has proven to be very helpful to me .
found dresser brought home wanted restore scrubbed put stain looked decided wanted restore pieces house	PERSON found a beautiful antique dresser . She brought it home and wanted to restore it . She scrubbed it and then put some stain on it . It looked amazing ! PERSON decided she wanted to restore more pieces for her house .
collecting toys cereal boxes had toys need collection get one bought boxes cereal opened boxes dumping grab toy toys had fell boxes	PERSON was collecting toys from cereal boxes . He had four out of the five toys need for the collection . To get the last one he bought five boxes of cereal . He opened all five boxes dumping them out to grab the toy . One after another the same toys he already had fell out of the boxes .
sat tree stand looking deer saw cross field fired shot fell loved deer hunting year	PERSON sat in his tree stand . He was looking for a deer . He saw one cross the field . He fired a shot and it fell . PERSON loved deer hunting every year .
loves swim used do day gym has time getting pool asked doctor do exercise stay doctor recommended walking treadmill gym gave try loves treadmill	PERSON loves to swim and used to do it every day at the gym . He is older now and has a hard time getting in and out of the pool . He asked his doctor what to do for exercise so he can stay healthy . The doctor recommended walking on the treadmill at the gym . PERSON gave it a try and loves the treadmill now .
wedding anniversary took wife honeymoon went train stayed side did got married had time	For our 25th wedding anniversary I took my wife on a 2nd honeymoon . We went back to LOCATION LOCATION by train . We stayed on the Canadian side . This is what we did when we first got married . We had a great time .
eating chocolates ate deal husband came home work remembered day ate chocolates bought valentine	PERSON was eating chocolates . She ate a great deal . Her husband came home from work . She then remembered what day it was . She ate all of the chocolates she bought him for Valentine 's .
dreamed wedding had planned queen regal married had money bought candy bars guests had do	PERSON dreamed of the perfect wedding . She had it all planned like the queen . It would be solemn and regal . But when she married PERSON , they had no money . So they bought candy bars for their guests and it had to do .
utilities bill afford decided stop using electricity bought candles bill	My utilities bill was expensive ! I could n't afford it . I decided to stop using electricity . I bought candles instead . My next bill was very affordable !
bed heard someone whispering felt chill run spine turned lamp bed walked closet opened find brother trying scare	While in bed , in the dark , I heard someone whispering . I felt a chill run up my spine . I turned on the lamp beside my bed . I walked toward the closet . I opened it to find my little brother trying to scare me .
day watching fish swim tank decided grabbing purse ran car drove petstore petstore had fish chose lady store helped find fish	One day PERSON was watching her fish , PERSON , swim in his tank . She decided that PERSON must be lonely all by himself . Grabbing her purse , PERSON ran to her car and drove to the petstore . At the petstore they had so many colorful fish to chose from ! The lady at the store helped her find the perfect new fish .
prom supposed everything going having time danced friends night song came find date dance floor went cool 's saw date making	The Senior Prom was supposed to be perfect . Everything was going well we were having a great time . We danced with our friends all night , then our special song came on . I could n't find my date on the dance floor so I went to cool off . That 's when I saw my date making out with my best-friend .
going learn play baseball today got baseball gear put baseball uniform fitted mitt dressed go play baseball mom drove baseball practice	PERSON was going to learn how to play baseball today . He got all his baseball gear ready . He put on his baseball uniform and fitted his mitt . After he was all dressed up , he was ready to go play baseball . PERSON 's mom drove him to baseball practice .
felt have liked charge decided ask parents sibling parents decided have babysit baby cousin	PERSON always felt that he should have been the oldest . He liked to be in charge . He decided to ask his parents for a new sibling . His parents decided to have him babysit his baby cousin . PERSON was happy to be the youngest from then on .
had forgotten study math exam teacher had sub test postponed relieved studied night test	PERSON had forgotten to study for his math exam . His teacher was sick and they had a sub . The test was postponed . PERSON was relieved . He studied hard that night for the test .
has working science 's developed equations relating mass energy knows lead weapon feels develop weapon describes ideas letter president	PERSON PERSON has been working on some special science . He 's developed equations relating mass to energy . He knows that this could lead to a powerful weapon . He feels that the LOCATION LOCATION should develop such a weapon first . He describes his ideas in a letter to the President .
bought computer did want turn tried everything fix problem took store found replaced	PERSON bought a new computer . It did n't want to turn on . He tried everything to fix the problem . He took it back to the store . It was found to be faulty and replaced .
ball got stuck roof boy told dad dad got ladder ladder dad got son ball store	The ball got stuck on the roof . The boy told his dad . His dad got the ladder . The ladder was too short . The dad got his son a new ball at the store .
cat devoted wife follows today wife closed door get dressed cat scratched carpet trying get wife said cat obsessed	Our cat is devoted to my wife . She follows her around . Today my wife closed the door to get dressed . The cat scratched the carpet trying to get in . My wife said the cat is obsessed .
enjoyed going runs went run block wore shoes shoes gave blister took week run owns running shoes wear	PERSON enjoyed going for runs . She went out for a run around the block but wore the wrong shoes . These shoes gave her a blister . It took her a whole week to be able to run again . PERSON now only owns running shoes for casual wear .
delivering pizza road runs something gets see hit had hit piece glass delivering pizza car trouble	PERSON is delivering a pizza . While on the road he runs over something . He gets out to see what he hit . He had hit a large piece of glass . PERSON was late delivering the pizza due to his car trouble .
worked ice warehouse wanted see sit ice sat felt felt time won contest gave	PERSON and PERSON worked in an ice warehouse . The wanted to see who could sit on ice the longest . The sat down and instantly felt cold . PERSON felt much more cold . Time won the contest after PERSON gave up quickly .
camera lens bought copy rolleiflex had look camera view subject use camera	My first good camera was a twin lens reflex . I bought a LOCATION . It was a copy of the famous Rolleiflex . You had to look down the camera to view the subject . Nowadays I just use a digital camera .
loves broccoli decided make broccoli cheese grabbed cheese cheese melt dish turned	PERSON loves broccoli . She decided to make broccoli and cheese . However , she grabbed the the wrong cheese . The cheese would not melt . PERSON 's dish still turned out okay .
had bought fridge online had delivered owner noticed thing opened found mess took hours clean thing	PERSON had bought a fridge online . She had it delivered by the previous owner . Immediately , she noticed that the thing was so gross . She opened it and found the worst mess ever . It took her hours to clean the entire thing .
yesterday birthday monday had go school knew had birthday party school excited day got party	Yesterday was PERSON 's birthday . It was a Monday , so he had to go to school . He knew he had a birthday party after school . He was excited all day . When he got to the party , he was very happy .
liked bacon breakfast came breakfast shocked box cheerios counter asked mom did make breakfast told year do	PERSON liked bacon for breakfast . So when he came down for breakfast he was shocked . Only a box of cheerios was on the counter . He asked his mom why he did n't make him breakfast . She told him he was forty Year 's old and he could do it himself .
trying bulk muscle lifting gym seeing results body read online needs eat calories did noticed results week	PERSON is trying to bulk up with some muscle . He is lifting more and more at the gym . Although he is not seeing any results with his body . He read online that he needs to eat double the calories then he was . He did that and noticed results within a week .
disappointed did make baseball team brother noticed offered help star athlete had lot tips player time tried chosen team gave brother hug	PERSON was disappointed when he did n't make the baseball team . His older brother PERSON noticed how upset he was and offered to help . PERSON was a star athlete and had a lot of valuable tips for PERSON . PERSON was a much better player the next time he tried out . He was chosen for the team and gave his brother a big hug .
adopted labrador puppy named loved run day injured hit car had fence installed hospital loved playing yard	PERSON adopted a Labrador puppy named PERSON . PERSON loved to run away whenever he could . One day , PERSON was injured when he was hit by a car . PERSON had a fence installed while he was in the veterinary hospital . PERSON loved playing in his new , safe yard .
mr poke donated millions dollars radio radio station aired news business practices mr poke demanded station stop airing stories station said duty inform public mr poke withdrew support radio	Mr Poke donated millions of dollars to public radio . The radio station aired some news on corrupt business practices . Mr Poke demanded the station stop airing such stories . The station said it was their duty to inform the public . Mr Poke angrily withdrew his financial support for public radio .
hoping get approved auto loan sat banker waiting hear qualify dismay informed credit went home got work fixing credit took year improved credit	PERSON was hoping to get approved for an auto loan . She sat with a banker waiting to hear if she would be able to qualify . To her dismay she was informed that her credit was too low . PERSON went home and got to work on fixing her credit . It took a year but eventually she improved her credit enough .
sitting country money preparing call mom did want talk dialed cat emerged brush sat lap conversation mother	I was sitting alone in a foreign country with no money . I was preparing to call my mom . I was very nervous and did n't really want to talk to her . As I dialed a beautiful white cat emerged from the brush . He sat on my lap during my entire conversation with my mother .
playing basketball friends jumped dunk ball ended breaking rim came crashing jumped way looked hands awe strength	PERSON was playing basketball with some friends . She jumped up to dunk the ball . She ended up breaking the rim . As it came crashing down , she jumped out of the way . PERSON looked at her hands , in awe of her strength .
took bag sunflower seeds asking made father allowed do began spilling sunflower seeds spilled sunflower seeds father said sunflower seeds banned house	Misty took a bag of sunflower seeds downstairs without asking . This made her father irritated , but he allowed her to do this . Then , she began spilling sunflower seeds . She spilled sunflower seeds even after her father said to be careful . Now , sunflower seeds are banned from the entire house .
grandpa finishing lunch jumped go friends ran car waited grandpa minutes went see taking walked find searching find keys	PERSON 's grandpa was finishing his lunch . She jumped up ready to go to a friends . PERSON ran to the car and waited for grandpa . After 5 minutes she went to see what was taking him so long . She walked in to find him searching , unable to find his keys .
students strung colored cereal pieces necklaces let students wear art rest day dismissing class wanted photograph necklaces asked students line picture having eaten cereal necklaces reduced strings	PERSON 's students eagerly strung colored cereal pieces onto necklaces . She let the students wear their art for the rest of the day . Before dismissing class , PERSON wanted to photograph the necklaces . She asked the students to line up for a picture . Having eaten the cereal , the necklaces were reduced to strings .
baseball player had game years noticed body giving wondered keep times decided retire	LOCATION was a great baseball player . He had been in the game for over twenty years . He noticed his body giving out more and more . He wondered if he could keep up with the times . LOCATION decided to retire .
kia had lost measuring cup making casserole needed forced eyeball ingredients had done feared food casserole came	Kia had lost her measuring cup . She was making a casserole and needed it badly ! She was forced to eyeball her ingredients . She had never done that and feared the food would be bad . But surprisingly , her casserole came out very tasty !
man named scared heights friends wanted overcome bought skydiving ticket knowledge had go jumped screamed life survived	A man named PERSON was scared of heights . His friends wanted him to overcome it . They bought him a skydiving ticket without his knowledge . He had to go . He jumped out and screamed for his life , but survived .
house making dinner son had come playing watched took sweater dirt spilled sweater floor had stop doing	PERSON was inside her house making dinner . Her son had just come in from playing outside . She watched as he took his sweater off . Suddenly , dirt spilled from his sweater all over the floor . PERSON had to stop what she was doing and clean it up .
yesterday airport had wait security line hour carrying items line dwindled relieved vowed go	Yesterday at the airport I had the longest wait at security . I was literally in line for over an hour . It was hard because I was carrying such heavy items . Finally as the line dwindled I was relieved . I vowed to never go through commercial again .
finishing novel nephew boy took book ripped shreds phased had made copy took copy slapped head	PERSON was finishing a new novel . Her nephew PERSON was a rude little boy . She took the book and ripped it to shreds . PERSON was n't phased , she had made a copy . She took the copy and slapped PERSON hard over the head with it .
balanced tightrope concentration heard girl cheering name turned saw girl lost balance tumbled ground caught saw girl laugh leave tent	PERSON balanced on the tightrope with much concentration . Then he heard a girl cheering his name . He turned ever so slightly , and saw the most beautiful girl . He lost his balance and tumbled to the ground . As the net caught him , he saw the girl laugh and leave the tent .
loved seeing sports played going hockey game did know anything sport excited took friends sat cheered home team	PERSON loved seeing sports played live . She was going to her first hockey game . She did n't know anything about the sport but she was excited . She took her closest friends . They all sat and cheered on their home team .
making oatmeal cookies put oven set timer minutes timer went opened oven door cookies had forgotten turn oven	PERSON was making her famous oatmeal cookies . She put them into the oven . She set the timer for nine minutes . When the timer went off she opened the oven door . The cookies were raw because she had forgotten to turn the oven on !
nuts kind attended grandma party had piece cake hours got rushed hospital having reaction nuts lady cake used nuts frosting	PERSON was highly allergic to nuts of all kind . He attended his grandma 's party and had a piece of cake . Hours later he got really sick and was rushed to the hospital . He was having an allergic reaction to nuts . The lady who baked the cake unknowingly used nuts for the frosting .
liked riding motorcycle friends warned scoffed night skidded hit truck shaken urging needed	PERSON liked riding his motorcycle really fast . His friends warned him to be careful but PERSON scoffed . One rainy night , he skidded and almost hit a truck . He was okay , but shaken up and grateful to be unhurt . It was the only urging he needed to be more careful from then on .
've girl child used want hair put blanket head ran felt woman 've worn hair	I 've always been a girly girl . As a child , I used to want long hair so bad . So , I put a blanket on my head and ran around . I felt like a glamorous woman . I 've worn long hair ever since then .
wanted tattoo get decided get star sat flinched started wondering made decision	PERSON really wanted a tattoo . Finally she was old enough to get one . She decided to get one of a star . As soon as she sat down , she flinched . PERSON started wondering whether she made the right decision .
parents made go church thought preacher said decided stop going	PERSON was n't very religious . His parents made him go to church . He thought it was creepy . What the preacher said was even worse . PERSON decided to stop going .
wanted get bicycle fixed bike technician fixed told buy decided picked bike rode trashed	PERSON wanted to get his bicycle fixed . The bike technician fixed it but told him he should buy a new one . He decided he would . He picked out a new bike . He rode out with it and trashed the old one .
finds has lot time work decides needs take hobby decides start playing video games finds fun have something do work	PERSON finds that he has a lot of free time after work . He decides he needs to take up a hobby . PERSON decides to start playing video games . He finds them fun . He is glad to have something to do after work .
friends trying sneak house left house kitchen light asked do stood doe eyed confused	PERSON and her friends were trying to sneak back into PERSON 's house . When they left the house was dark . Now the kitchen light was on . PERSON asked PERSON what to do . PERSON stood doe eyed , clearly scared , and confused .
had daughters loved spending time girls took shopping day bought lot clothes laughed lot loved making memories girls	PERSON had many daughters . She loved spending time with the crazy girls . She took them all shopping one day . They bought a lot of clothes and laughed a lot . PERSON loved making memories with her girls !
suffered anxiety therapist recommended get cat looked shelters visited adopted cat	. PERSON suffered from anxiety Her therapist recommended she get a cat . PERSON looked up several likely shelters and visited them . PERSON adopted a cat . PERSON is much less anxious now .
had go bathroom done flushed toilet toilet did overflowed had get plunger unclog toilet unclogged had spend day cleaning water	PERSON had to go to the bathroom . When he was done , he flushed the toilet . The toilet did n't flush and overflowed . He had to get a plunger to unclog the toilet . He unclogged it but had to spend the day cleaning the water out .
woman dress offered mailman soda declined horoscope had said water today mailman knew soda water knew horoscopes	A thirsty woman in a green dress offered the mailman a soda . He politely declined . His horoscope had said to be aware of water today . The mailman knew soda was mostly water . Just like he knew horoscopes were always true .
computer running opened screwdriver saw clogged dust blew dust compressed air	PERSON 's computer was running funny . It was really slow . She opened it up with a screwdriver . She saw it was clogged with dust ! She blew the dust out with some compressed air .
married years told going get gorilla tattoo touched going meet mistress noticed tattoo looked accused cheating lied	PERSON and PERSON were married for many years . PERSON told her he was going to get his gorilla tattoo touched up . He was really going to meet his mistress . PERSON noticed that PERSON 's tattoo looked the same . She accused him of cheating , but PERSON lied to her .
started losing eyesight years figure read blackboard teacher scolded taking notes told words called parents had get glasses	I started losing eyesight by 8 years old . I could n't figure out why I could n't read the blackboard anymore . The teacher scolded me for not taking notes . I told him the words were too blurry . He called my parents , and I had to get glasses .
year took date dinner date flirted year waitress time excused saying had use restroom came waitress got tip	PERSON is fifty Year 's old . He took his blind date PERSON to dinner for their first date . PERSON flirted with the 20 year old waitress the whole time . PERSON excused herself saying she had to use the restroom . PERSON never came back and the waitress got a lousy tip .
bought shirt goodwill liked way fit wore friends night friends told girl shirt realized did care	PERSON bought a shirt at goodwill . He liked the way it fit . He wore it out with friends one night . His friends told him it was a girl 's shirt . PERSON realized it but did n't care .
remember pregnancy had morning sickness time co-workers experiencing run comfort room have vomit gave birth 's	I remember my first pregnancy was too hard . I had this morning sickness most of the time . Even my co-workers were experiencing this because of me . I almost run to the comfort room when i have to vomit . But after i gave birth it 's all worth it .
cleaning room cleaning couch discovered ipod had missing years turned found photos friends made smile	PERSON was cleaning her room . She was cleaning the couch when she discovered her old iPod . It had been missing for years . She turned it on . There she found old photos of her and her friends that made her smile .
kids wanted build snowman rolled balls body had help stack balls top borrowed hat dad closet gave carrot nose finishing touch	PERSON 's kids wanted to build a giant snowman . They rolled three large balls for the body . She had to help them stack the balls one on top of the other . They borrowed a hat from their dad 's closet . PERSON gave them a giant carrot for the nose for the finishing touch .
amber drove home work night road flooded drove tow truck had come tow car had go shop get repaired cost boyfriend lot money get fixed	Amber drove home from work one night The road was flooded and she drove into it The tow truck had to come to tow her poor car It had to go to the shop to get repaired It cost her boyfriend a lot of money to get fixed
had eaten dinner stop eating done felt had take ginger tea drank felt	PERSON had eaten too much . Her dinner was delicious and she could n't stop eating . When she was done she felt sick . She had to take some ginger tea . Thankfully when she drank it she felt better .
wanted make bread yeast grabbed ingredients found needed egg asked neighbor egg yeast neighbor baker had supplies enjoyed home made bread night	PERSON wanted to make her own bread but was short on yeast . She grabbed all the ingredients and found she needed an egg too . PERSON asked her neighbor for an egg and some yeast . Since PERSON 's neighbor was a baker he had the supplies . PERSON enjoyed home made bread that night .
bullied school told teacher mother bully got trouble got detention day detention apologized sue mean became friends stopped bullying	PERSON was being bullied in school . She told her teacher as well as her mother . The bully got into trouble and got detention . After a day in detention he apologized to Sue for being mean . They became friends and he stopped bullying her .
person wanted learn knit did have family show did have neighbor called grandma asked grandma teach knit lady taught basics knitting crochet	PERSON was a very independent person and wanted to learn how to knit . She did n't have any family that could show her how . PERSON did have an elderly neighbor that she called grandma . PERSON asked her fake grandma to teach her how to knit . The elderly lady taught PERSON all the basics of knitting and crochet .
knitting had set needles wanted test knit blanket hour decided needles wait see knit	PERSON was knitting . She had a new set of needles that she wanted to test out . She knit a whole blanket in an hour . PERSON decided her new needles were really great ! She could n't wait to see what she could knit with them .
dinner co-workers felt urge sneeze tried muffle bit dinner made pass gas everyone	I was at a fancy dinner with some co-workers . All of a sudden I felt the urge to sneeze . I tried to muffle it a bit since we were at dinner . Instead it made me pass gas . Everyone was mortified .
decided have hamptons house did have wanted take care thought got house felt	PERSON decided to have PERSON over her hamptons house . PERSON did not have much and PERSON wanted to take care of her . PERSON thought it was nice . When they got to the house it was beautiful . PERSON felt so thankful .
'm coffee drinker have 've tried coffee including countries make home go get reason gas station house has coffee 's place choice 'm getting coffee	I 'm an avid coffee drinker and I always have been . I 've tried coffee from all over including different countries . Sometimes I make it at home and sometimes I go out to get it . For some reason the gas station by my house has the best coffee . It 's my place of choice when I 'm out getting coffee .
had gotten pencil had taken people minutes chasing decided put pencils take put desk left day pencils classroom	PERSON had finally gotten her pencil back from PERSON . It had taken 2 people and 5 minutes of chasing . PERSON decided to put her pencils away so he could n't take them . She put them in her desk and left for the day . She was sure her pencils would be safe in the classroom overnight .
had broken girlfriend had months hour had year phone week broke day time happened	PERSON had just broken up with his girlfriend . They had been together for two months . Within an hour he had his ex from a year ago on the phone . They were back together in a week . They broke up within a day just like the last time this happened .
bought lottery ticket thought won prize roommate told prank ticket heart broken	PERSON bought a lottery ticket . He thought he won the big prize . His roommate told him it was just a prank . PERSON 's ticket was fake . PERSON was heart broken .
eats desk boss tells day spilled spaghetti got sauce keyboard keyboard had replaced	PERSON always eats at his desk . His boss always tells him not to . One day PERSON spilled spaghetti . He got sauce all over his keyboard . The keyboard had to be replaced .
walked home smelled odor looked find source decided clean house get smell done realized odor shoes threw shoes dumpster wore pair	PERSON walked into his home and smelled a really bad odor . He looked all over but could n't find the source . He decided to clean the whole house to get rid of the smell . When he was done , he realized the odor was from his shoes . PERSON threw those shoes in the dumpster and wore another pair .
did eating pasta family went eat grandmother house mother had cooked spaghetti lied said made sandwich got home	PERSON did n't like eating pasta . Her family went eat at her grandmother 's house . PERSON 's mother had cooked spaghetti . PERSON lied and said she was n't hungry . PERSON made herself a sandwich when she got home .
bought sports car wanted see go sped freeway reached mph go	PERSON bought a new sports car . And he wanted to see how fast it could go . So he sped down a freeway at 2 AM . And he reached 140 MPH . But he was too scared to go any faster .
driving instructor arrived left house drove house turnpike driving school recommended taking driving test today taking advice consideration signed performed turns passed test	When my driving instructor arrived , I left the house . We drove , from my house , to the turnpike and driving school . He recommended taking the driving test today . Taking his advice into consideration , I signed up for it . Although I performed poorly on three-point turns , I passed the test !
had work assignment do did want do decided bear get done work employer thought	I had one more work assignment to do . I did not want to do it . I decided to bear down and get it done . It was not my best work . My employer still thought it was OK though .
walking street saw man man begged money did give money felt did help day bought ham brought man felt man	PERSON was walking down the street and saw a homeless man . The homeless man begged him for money . PERSON did n't give him money but felt bad he did n't help him . The next day PERSON bought a ham and brought it to the homeless man . PERSON no longer felt bad about the homeless man .
had going auctions months looking furniture day spotted buffet bidding kept going going cave spent fortune piece	PERSON had been going to auctions for months . She was looking for antique furniture . One day , she spotted a beautiful buffet . Bidding kept going higher but she was not going to cave ! She spent a fortune on the piece .
neighbors hated decided build wall had see had brick wall erected property hated wall weeks built vandalized wall paint	Two neighbors , PERSON and PERSON , hated each other . PERSON decided to build a big wall so he never had to see PERSON . PERSON had a large brick wall erected on his property . PERSON hated the wall very much . A few weeks after it was built , PERSON vandalized PERSON 's wall with paint .
had neighbor widow heard neighbors health began failing hired nurse come day neighbor home visited widow passed spoke memorial service	PERSON had a neighbor who was a widow . PERSON heard from other neighbors that her health began failing her . PERSON hired a private nurse to come every day to his neighbor 's home . PERSON visited the widow regularly . When she passed , PERSON spoke eloquently at her memorial service .
year went doctor told drink coffee eat sweets matilda went home poured cup coffee grandson scolded listening doctor year didn	PERSON was 95 Year 's old , and went to the doctor . He told her not to drink so much coffee , or eat too many sweets . Matilda went home and promptly poured a cup of coffee . PERSON 's grandson scolded her for not listening to the doctor . But PERSON was 95 Year 's old , and she didn
playing basketball friends someone threw ball right face surprise tooth cracked look dentist fix	PERSON was playing basketball with his friends . Suddenly someone threw the ball right at his face . To his surprise his tooth cracked . He was so sad and worried it would look ugly forever . Luckily a dentist was able to fix it up quickly .
man came strategy moved markers board explained moves soldiers soldiers asked questions man answered	The man came up with a strategy . He moved some markers on a board . He explained the moves to his soldiers . His soldiers asked questions . The man answered well .
weekend fiance visited considering moving year went check houses met realtors enjoyed city decided move time year	The other weekend my fiance and I visited LOCATION . We are considering moving there in a year or so . We went to check out the houses and met with few realtors . Ultimately , we both really enjoyed the city . We decided we will likely move there this time next year .
watched episodes cartoon did thought friend like told encouraged watch obsessed cartoon joke dislike allowed find	I watched the first few episodes of a cartoon but did n't like it . I thought my friend would like it . I told her about it and encouraged her to watch it . Now she is obsessed with this cartoon . We joke about how I dislike it but allowed her to find it .
finished college years learned calculus decided learn topic borrowed textbook library studied worked learn topics knew calculus	PERSON finished college Years ago but he never learned calculus . He decided to learn the topic independently . He borrowed a calculus textbook from the library and studied it . PERSON worked very hard to learn all of the topics . PERSON was proud that he finally knew calculus .
tv actor nominated award arrives award show wins award show goes home award	PERSON is a tv actor . He is nominated for an award . He arrives at the award show . He wins the award at the show . PERSON goes home with his award .
loved kinds food owned collection sauces ordered food menu day ordered wings restaurant mouth fire days met match	PERSON loved all kinds of spicy food . He owned an impressive collection of hot sauces . He always ordered the spiciest food on the menu . Until one day , he ordered uber hot wings from a local restaurant . His mouth was on fire for days , and PERSON finally met his match .
had job interview position had idea work went shaking walked got job	PERSON had a job interview for a new position . She was quite nervous . She had no idea how it would work out . She went in shaking . Luckily when she walked out she got the job .
brother had house fought father dad foot pounds felt	PERSON 's brother PERSON had been out of the house . Now he was back . He 'd fought their father . Their dad was a foot taller and 50 pounds bigger . PERSON no longer felt safe with him around .
went amusement park boys had lot fun water rides go roller coasters rode roller coasters waited ground teased riding rides	PERSON and PERSON went to the amusement park . The boys had a lot of fun on the water rides . PERSON was afraid to go on the roller coasters . PERSON rode the roller coasters while PERSON waited on the ground . PERSON teased PERSON for not riding all the rides .
professor liked teacher history church sunday student stood talk professor did remember student worried student offended professor invited church professor asked forgiveness had stroke	Professor PERSON was a well liked teacher of black history . At church one Sunday , a student stood by him to talk to him . Professor PERSON did n't remember the student and was worried . The student was offended , plus , Professor PERSON invited her to church ! Professor PERSON asked for forgiveness , he 'd recently had a stroke .
put lot christmas decorations neighbors liked took christmas neighbors started complain decided take	PERSON put up a lot of Christmas decorations . His neighbors really liked them at first . PERSON never took them down after Christmas . His neighbors started to complain . PERSON finally decided to take them down .
friend daughter t came visit week lives tn used live rented car t get day car t cut people argued t found taking meds	My friend PERSON 's daughter T came up to visit him last week . She lives in TN but used to live in LOCATION . PERSON rented a car for T to get around . One day PERSON was in the car when T cut off three people . PERSON argued with T as he found she was not taking her bipolar meds .
wanted singer practiced singer decided try painting had discovered talent gave painting try	PERSON wanted to be a singer . She practiced very hard , but she just was n't a very good singer . She decided to try painting instead , and she was really good at that ! PERSON was happy she had discovered her true talent . She was glad she gave painting a try .
worked tailor shop summer duties included altering dresses received wedding dress alter worked day night dress make client loved invited wedding	PERSON worked at a tailor 's shop during the summer . His duties included altering dresses . He received one wedding dress to alter that was very beautiful . He worked day and night on this dress to make it just right . The client loved it so much that she invited PERSON to the wedding .
excited day wedding day worried realized moment had ordered cake called one fulfill request decided wedding pie have suffice	PERSON was excited , the day was finally here . It was her wedding day , but she was still worried that was off . She realized at the last moment , she had never ordered a cake . She called everywhere , but no one could fulfill her request . PERSON decided that a wedding pie would have to suffice .
man retired had nothing do watched television health became died heart attack	The man retired . He had nothing to do . He watched too much television . His health became worse . He died from a heart attack .
daughter years has friend friend fight apologize fight	My daughter is twelve years old . She has a best friend . Sometimes she and her best friend fight . Eventually they apologize to each other . After the fight is over , they are very happy .
day work sat chair tv engaged show heard noise looked saw hand resting window glass got grabbed gun walked got window saw hand print person	PERSON was tired one day after work and sat down on his chair by the tv . PERSON was engaged in the show but heard a sudden noise . He looked over and saw a hand obviously resting on the window glass . PERSON got up and grabbed a gun then walked outside . When he got to the window , he saw a hand print , but no person .
boyfriend color decided color painted bedroom wall violet loved broke rebelled repainting room neon color	When I was 13 , my boyfriend 's favorite color was purple . I decided purple was my favorite color too , and painted my bedroom . Every wall was violet , and I loved it very much . Then he broke up with me , and I was very sad . I rebelled by repainting my room neon green , a very ugly color .
had problem computer took computer repair shop day shop called will told computer loaded viruses had buy computer	Will had a problem with his computer . Will took the computer into a local repair shop . The next day the shop called Will . They told PERSON that his computer was loaded with viruses . Will had to buy a new computer !
walking home store noticed dogs did do started attacking tried breaking fight neighbors pulled dogs	When walking home from a convenient store I noticed two dogs . At first they did n't do much . Then , out of nowhere they started attacking each other . I tried breaking the fight at first , but I could n't by myself . Me and the neighbors eventually pulled the dogs away from each other .
fishing uncles seemed fish began complaining pole got nibble tried reel caught nothing end did catch anything	PERSON was fishing with her uncles . She was bummed because there seemed to be no fish . Just when she began complaining , her pole got a nibble . She tried to reel it in but still caught nothing . In the end , she did n't catch anything at all .
got lot candy halloween had bags day ate candy got night did stuff	PERSON got a lot of candy on Halloween . He had two bags full . The day after PERSON ate as much candy as he could . He got incredibly sick that night . From then on PERSON did n't stuff himself as much .
day doing laundry got clothes put basket shirt had stain soaked scrubbed wash stain gone	One day PERSON was doing laundry . He got together all of his clothes and put them in a basket . One shirt had a big blue stain on it . PERSON soaked it in a special cleaner and scrubbed it first . After the wash , the stain was nearly gone .
saw go bathroom friend followed froze saw going pummel brat friend june came saved fight	PERSON saw PERSON go to the bathroom . PERSON and her friend PERSON followed her . PERSON froze when she saw PERSON . PERSON was going to pummel this brat . Just when PERSON 's friend June came in and saved PERSON from a fight .
went boston symphony orchestra concert guest soloist violinist performance violin string broke everyone waited brought violin crowd applauded end performance	I went to a Boston Symphony Orchestra concert in 2006 . The guest soloist was a violinist . During the performance the violin string broke . Everyone waited until they brought out another violin . The crowd eagerly applauded at the end of the performance .
graduated college lot debt money owed making worry rejected job interviews interviewing walmart bought gun sports section killed trying rob customer service manager	PERSON graduated from college with a lot of debt . All the money she owed was making her worry . She was rejected at several job interviews . After interviewing at Walmart , she bought a gun in the sports section . She was killed while trying to rob a customer service manager .
realizes stereo system home getting decides look replacement buys stereo system sale store sets home sounds feels has stereo system home	PERSON realizes that his stereo system at home is getting old . He decides to look for a replacement . PERSON buys a great stereo system on sale at a local store . He sets it up at home and it sounds great ! PERSON feels happy now that he has a new stereo system at home .
yesterday went flower picking have garden yard went picking picked tulips roses done put vase got compliments flowers	Yesterday I went flower picking . I have a nice garden in my yard and went picking it in . I picked tulips and roses . When I was done I put it in a vase . I got so many compliments on the flowers .
decided buy house market doing meant buy house decided invest money housing market housing market collapsed	PERSON decided to buy a new house . Unfortunately the American market was not doing well . This meant it was too risky for PERSON to buy a house . Instead , PERSON decided to invest his money in the French housing market . Unfortunately , the French housing market soon collapsed !
do volunteer work profit group called inti group runs soccer art school kids today director sent grant proposal proofread made edits returned proposal hope get grant	I do volunteer work for a non profit group called Inti . The group runs a soccer and art school for poor kids . Today my director sent me a grant proposal to proofread . I made a few edits and returned the proposal . I hope we get the $ 35,000 grant .
manager introduced employee guys excited did lot favors treated person approached	Our manager introduced us to a new employee . Since she was attractive , all of the guys were excited . They did a lot of favors for her . Unlike them , I treated her as an ordinary person . Despite being silent , she approached me first .
playing bird decided perch shoulder excited took picture bird bird flew realized bird defecated shoulder	PERSON was playing outside . All of the sudden , a bird decided to perch on his shoulder . PERSON was excited and took a picture with the bird . The bird suddenly flew away . PERSON realized that the bird defecated on his shoulder .
kia classmate pulled gun science class day everyone screamed cowered desks police notified came found bb gun took student evaluation	Kia 's classmate pulled a gun in science class one day . Everyone screamed and cowered under desks . The police were notified and came quickly . Then found that it was only a BB gun , thankfully . They took the student away for a mental evaluation .
came corral horses man road needed sell purchased name muffin muffin came live farm muffin taught bill cherish friends	PERSON came upon a corral of horses . The man down the road needed to sell them . He purchased one and name it Muffin . Muffin came to live on PERSON 's farm . Muffin taught bill how to cherish friends again .
returned beach sand shoes stopped porch took shoes dumped sand put hour mother called living room got trouble sand had tracked house	PERSON returned from the beach with sand in her shoes . She stopped on the porch and took her shoes off . She dumped the sand out and put them back on . An hour later her mother called her to the living room . PERSON got in trouble because sand had been tracked through the house .
had created hit movies signed twitter account had dozens mean messages tweet said going die said movies suck closed twitter account stopped using media panel films fan begged come twitter	PERSON PERSON had created two hit movies . He signed into his Twitter account and had dozens of mean messages . One tweet said he was going to die , another said his movies suck . PERSON closed his Twitter account and stopped using social media . At a panel about his films , a fan begged him to come back to Twitter .
feels have children has met woman wants have kids friend recommends try adopting son adopts son becomes father became father	PERSON feels sad that he may never have children . However , he has n't met a woman he wants to have kids with . A friend recommends he try adopting a son instead . He adopts a son and becomes a great father . PERSON is very happy that he became a father .
lived years fought lot disrupted neighbors neighbors grew fights filed complaints landlord get complaint day months landlord got tired evicted	PERSON and PERSON lived together for two years . They fought a lot and it disrupted their neighbors . Their neighbors grew tired of the fights and filed complaints . The landlord would get a complaint every day for 6 months . The landlord got tired of it and evicted PERSON and PERSON .
summer camp kids playing get know game partnered someone activity boy introduced bonded name	PERSON was at summer camp . The kids were playing a get to know you game . PERSON was partnered up with someone for an activity . The boy introduced himself as PERSON . The two instantly bonded over their shared name .
remember dance prom night school dance friend do know 'm asked dance night 'm friend ask gave rose	I remember my first dance was on our prom night in high school . My first dance is my best friend actually . I do n't know why i 'm the first that he asked for a dance that night . Maybe because i 'm his best friend . When he is about to ask me he gave me a rose first .
wanted buy bread store went store bread gone wanted bread decided open bakery has bread dream	PERSON wanted to buy bread at the store . He went to the store but all the bread was gone . PERSON never wanted to be without bread again . He decided to open his own bakery . Now PERSON has all the bread he could dream of .
got home looking homework searched room found baby brother ripping homework pages eating did attack brother threw remains did homework	When PERSON got home , he was looking for his homework . He searched in the room and found his baby brother . He was ripping the homework pages apart and eating them . As mad as PERSON was , he did n't attack his brother . He threw the remains away and did the homework all over again .
boss yelled work explained caught traffic told fired decided leave get work time	My boss was very mad at me . He yelled at me for being late for work . I explained that I was usually caught in traffic . He told me if I was late again I would be fired . I decided to leave really early to get to work on time .
dreamed beeping looked dream find source woke realized coming microwave	I dreamed there was a constant beeping . I looked for it everywhere in my dream . I could n't find the source . I finally woke up . I realized it was coming from the microwave .
had food allergies eating asked ingredients dish yesterday restaurant served nuts ate nuts realizing went shock result ingesting nuts	PERSON had severe food allergies . When eating out she always asked about ingredients in a dish . Yesterday in a restaurant she was mistakenly served nuts . She ate the nuts without realizing what they were . She went into anaphylactic shock as a result of ingesting nuts .
person hated people class stole books classmate threw garbage had friends	PERSON was a mean person to many . She hated most people in her class . She stole the books from a classmate . She then threw them in the garbage . PERSON had no friends after that .
loved playing card game called joker wild decided set joker wild tournament friends friend did want participate tournament friends felt cheated win joker wild disappointed play friends	PERSON loved playing a card game called Joker 's Wild . PERSON decided to set up a Joker 's Wild tournament with his friends . However , PERSON 's friend did not want to participate in the tournament . PERSON 's friends felt that PERSON always cheated to win Joker 's Wild . PERSON was disappointed that he could not play with his friends .
sister having sleepover friends decided prank waited watching movie jumped scared realized	PERSON 's sister was having a sleepover with friends . He decided to prank them . He waited until they were watching a scary movie . Then , he jumped out and scared them . When they realized who it was , they were so annoyed .
bed sleeping felt tickle arm turned light bug bed called exterminator day	PERSON was in bed sleeping . He felt a tickle on his arm . PERSON turned on the light . There was a bug in his bed . PERSON called his exterminator the next day .
fan protest songwriting decided research life learned died suffered illness find person	I am a big fan of PERSON PERSON . His protest songwriting is as good as PERSON PERSON 's . I decided to research his life . I learned that he died very young and suffered from mental illness . Now I find PERSON PERSON a tragic as well as inspiring person .
driving truck highway paying attention signs failed see sign warned overpass truck clear overpass got fired wrecked truck	PERSON was driving a large truck on the highway . He was tired and was n't paying attention to the signs . He failed to see the sign that warned of a low overpass ahead . PERSON 's truck was too tall to clear the overpass . PERSON got fired after he wrecked the truck .
had wanted live seemed university applied visa go work got job barmaid known friends	PERSON had always wanted to live in LOCATION . Being from the LOCATION , LOCATION seemed exotic and exciting for her . After university , she applied for a visa to go and work there . She quickly got a job as a barmaid in LOCATION . She was always known as PERSON in LOCATION to her friends .
day couple touring city anniversary 've seen sites taken lots photos day going pizza year couple returns experience	It was a beautiful day in LOCATION . A couple is touring the city for their anniversary . They 've seen all the sites and taken lots of photos . The day is nearly over and they are going for pizza . Every year the couple returns to LOCATION for the awesome experience .
diet craving sweets boiled pot gelatin added poured molds let set fridge jello dessert snacked dessert	PERSON was on a diet but craving sweets . He boiled up a pot of gelatin and added LOCATION . Then he poured it into molds and let it set in the fridge . Soon his sugar-free Jello dessert was ready . PERSON snacked on his low-calorie dessert happily !
had dog named hated storms news issued storm warning evening knew had comfort storm comforted	PERSON had a dog named PERSON . PERSON hated storms . The news issued a storm warning for this evening . PERSON knew she had to comfort PERSON during the storm . PERSON was much more because PERSON comforted her .
swimming home felt tried scratch felt found made	PERSON was out swimming . After he was home he felt itchy . He tried not to scratch . Eventually PERSON felt better . He never found out what made him so itchy .
has hosted party feels realizes needs wash dishes begins cleaning plates continues cleaning glasses finished cleaning dishes sleeps day	PERSON has just hosted a terrific party . She feels tired , but realizes that she needs to wash dishes . She begins by cleaning plates , and then continues by cleaning glasses . Finally she is finished cleaning the dishes . She sleeps soundly after a long but enjoyable day .
stone boy loved play football day playing football playground got hurt boy threw football hit face stone glasses got broken got bruise day stone playing football	Stone was a sweet boy who loved to play football . One day he was playing football on the playground when he got hurt . Another boy threw the football hard and it hit him in the face . Stone 's glasses got broken and he got a bruise . After that day , Stone was always very careful playing football .
has lost ability walk breaking legs work doctor told time start walking tried day day get feet walk weeks manage walk door walking work	PERSON has lost his ability to walk after breaking both legs at work . His doctor told him that it was time for him to start walking again . He tried day after day to get on his feet but could still not walk . After 8 weeks he finally could manage to walk to his back door . Now he is fully capable of walking and is back to work .
friends needed home hanging lost track time got home midnight mom grounded	PERSON was out with friends . He needed to be home at ten . While hanging out , he lost track of time . When he got home it was midnight . His mom grounded him for being late .
matt loved star wars excited see movie went buy tickets sold buy tickets found tickets ground	Matt really loved Star Wars . He was really excited to see the new movie . He went to buy tickets , but they were all sold out . PERSON was sad about not being able to buy tickets . Then he found some tickets on the ground and he was happy .
show liked record watch way did have watch commercials forgot record show had wait online watch	PERSON 's favorite show was on . But she liked to record it and watch it later . This way she did n't have to watch commercials . However she forgot to record her favorite show . PERSON was sad she had to wait until it was available online to watch .
went breakfast speech blurred worker alarmed called ambulance went hospital had stroke passed week	PERSON went to PERSON 's for breakfast . His speech was blurred , so the worker was alarmed . She called an ambulance , and PERSON went to the hospital . PERSON had a stroke . PERSON passed away a week later .
has years wants job has had trouble finding gets interview newspaper works prepare newspaper interview preparation pays offered job	PERSON has been unemployed for Years . She wants a job but has had trouble finding one . Finally she gets an interview with a local newspaper . PERSON works very hard to prepare for the newspaper interview . Her preparation pays off when she is offered a job !
wedding ring fell faucet ring fell reach used plumber took pipes faucet ring retrieve	PERSON 's wedding ring fell into the faucet . The ring fell too far for her to reach . Luckily she used to be a trained plumber . She frustratingly took apart the upper pipes of her faucet . Although her ring was dirty , she was happy to be able to retrieve it .
attended piano recital parents music inspired learn play piano started taking lessons years held piano recital crowd applauded felt	PERSON attended a piano recital with her parents . The beautiful music inspired her to learn to play the piano . She started taking lessons enthusiastically . Two years later she held her own piano recital . As the crowd applauded , PERSON felt very proud of herself .
habits stopped brushing teeth people work complain got someone offered breath mints took hint brushed teeth	PERSON was lazy about his habits . He stopped brushing his teeth everyday . People at work would complain . It got so bad someone offered him breath mints . He took the hint and brushed his teeth more often .
fleet ships advanced island submarine snuck submarine fired torpedo ships ship exploded ships fleet scattered	The fleet of ships advanced towards the island . A submarine snuck up on them . The submarine fired a torpedo at one of the ships . The ship exploded . The other ships in the fleet scattered .
man made joke woman called man wanted look started speaking voice made woman respect	The man made a lewd joke . A woman called him childish . The man wanted to look more adult . He started speaking in a lower voice . It made the woman respect him .
band set show drummer find bass drum asked guitarist help went van look base drum sitting van	The band set up for a show . The drummer could n't find his bass drum . He asked the guitarist for help . They went out to the van to look . The base drum was sitting next to the van .
had trained swim competition weeks came got vomited turn swim had happened family concerned ended swimming race setting record	PERSON had trained for the swim competition for weeks . Once it finally came she got really nervous . She vomited just before it was her turn to swim . This had never happened before so PERSON and her family were concerned . PERSON ended up swimming her best race ever and setting a record .
family bought boat kept running gas made time did know happened boat seem gas sitting fit realized air bubble line did have problems	My family bought a boat and it kept running out of gas . We made sure it was full each time so we did n't know what was happened The boat would seem full of gas but after sitting , more could fit . We realized there was an air bubble in the line and it was n't full . We did n't have problems after that .
had guinea pigs cage had fleece bedding did want wash bedding house fur went laundromat felt closed day fur dryer vents	PERSON had three adorable guinea pigs . Their cage had fleece for bedding . But PERSON did n't want to wash the bedding at her house due to fur . She went to the laundromat . She felt bad when they closed for a day due to fur in the dryer vents .
needed get suit wedding deal suits bought decided wear store drove home realized left clothes store called store agreed pick	PERSON needed to get a suit for an upcoming wedding . There was a deal on suits so he bought two . He decided to wear one out of the store . Once he drove home he realized he left his old clothes at the store . PERSON called the store and agreed to pick them up later .
son went rock climbing weekend fell ground ankle twisted wife rushed hospital had have surgery	PERSON and his son went rock climbing last weekend . PERSON suddenly fell to the ground . His ankle was twisted badly . PERSON 's wife rushed him to the hospital . PERSON had to have surgery immediately .
bought house moved house week water leak house called plumber plumber fixed leak	PERSON bought a house . She moved to the new house last week . There was a water leak in the new house . PERSON called the plumber . The plumber fixed the leak .
depressed grandparents trying cheer attempts made tried wanted left asked grandparents leave locked door	PERSON was depressed . Her grandparents were trying to cheer her up . Their attempts only made it worse . She tried to be polite , but she just wanted to be left alone . She asked her grandparents to leave her alone and locked her door .
ivy needed water plants turned sprinkler ivy filled watering poured water flowerpot ivy turned sprinkler	Ivy needed to water the plants . She turned on the sprinkler . Ivy filled the watering can . She poured some water in a flowerpot . Ivy then turned off the sprinkler .
put self hook wall desk home put scratcher shoehorn put jacket hook came tumbling buying nail hook tomorrow	I put a self adhesive hook up on the wall near my desk at home . I put a back scratcher and a shoehorn up . I then put on a thin jacket . The hook came tumbling down . I am buying a nail hook tomorrow .
family went downtown looked war memorial read names carved stone felt walked home	The family went downtown . They looked at the war memorial . They read the names carved into the stone . They felt solemn . They walked home quietly and respectfully .
friends mom did set curfew called check told waiting felt situation decided go home time	PERSON was out with friends . His mom did n't set a curfew but called to check in on him . She told him that she was waiting up for him . PERSON felt bad about the situation . He decided to go home at a reasonable time .
played basketball school team missed throws coach recommended practice practiced throws hours scoring game practiced	PERSON played basketball for his school 's team . And he always missed free throws . His coach recommended to practice them more often . So PERSON practiced free throws for four hours everyday . After scoring during a game , PERSON was glad he practiced so much .
worked lose pounds began gain stopped gaining worked lose regained weight	PERSON worked hard to lose 20 pounds . She was very proud of herself ! But then she began to gain it back . After the first 10 , she stopped herself from gaining . Then she worked again to lose the regained weight .
sister law brother had polio born baby mother noticed legs kicking took hospital diagnosed polio family moved house had	My sister in law 's brother had polio . He was born healthy . When he was a baby his mother noticed his legs were not kicking . They took him to the hospital and he was diagnosed with polio . The family moved out of the house they had .
loves filling bird feeders home enjoys seeing variety birds attract birds glare window fed fills feeders birds alert friends chirping food supplied loves seeing	PERSON loves filling the bird feeders at his home . He enjoys seeing the wide variety of birds that they attract . The birds glare at him through the window if they are not fed . When he fills the feeders , the birds alert their friends by chirping . After fresh food is supplied , PERSON loves seeing them so happy .
wanted have dog decided go pound rescue dog got pound saw dog dog looked eyes knew took dog home	PERSON wanted very badly to have a dog of his very own . He decided he would go to the pound to rescue a dog . When he got to the pound , he saw a beautiful white dog . The dog looked at him with her big brown eyes , and he knew she was his PERSON took the dog home and was very happy .
day got pet ferret named whiskers whiskers bonded cuddled lot got	One day PERSON got a pet ferret . She named him Whiskers . Whiskers and PERSON bonded immediately . They cuddled a lot . PERSON was glad she got him !
yesterday went clothing store got waiting hour believe line done shopping waiting hours knew go	Yesterday I went to the clothing store . When I got there I was waiting for about an hour . I could n't believe how long the line was . When I was done shopping , I was waiting three hours . I knew never to go back again .
has beaten empire president had make decision invade use weapon consulted advisers decided use bomb	LOCATION has beaten back the Japanese Empire . The President had to make a decision . Would he invade LOCATION or use his new weapon ? He consulted with many advisers . He decided to use the bomb .
had brother looked brother kept getting fights school tried keep fighting day got head helped brother resolve conflict fighting	PERSON had a very irresponsible brother who he looked after . His younger brother , PERSON , kept getting into fights at school . PERSON tried his best to keep him from fighting . One day PERSON got in over his head and was afraid . PERSON helped his brother resolve the conflict without fighting .
photography class teacher let students go campus take pictures did have car did know anyone class car had take pictures campus	PERSON was in a photography class . Her teacher let any of the students go off campus to take pictures . PERSON did n't have a car , though . She did n't even know anyone in class with a car . Instead she had to take pictures on campus .
library decided look books found absorbed fantasy novel reading did weeks loved reading libraries	PERSON was at a library . And he decided to look through some books for once . He found himself absorbed in a fantasy novel . And reading it was all he did for several weeks . Afterwards , PERSON loved reading and libraries .
parents got month birthday sister born child point had changed did seem had sibling	When I was 14 my parents got pregnant . A month after my 15th birthday , by sister was born . I was an only child up till that point . Being honest , not much had changed . I was old enough that it did n't even seem like I had a sibling .
struggling musician had hit people wrote hit wonder wrote song prove everyone song went hit proved everyone	PERSON was a struggling musician . He had one hit . People wrote him off as a one hit wonder . He wrote a song to prove everyone wrong . The song went on to be a huge hit and proved everyone wrong .
asked father sign mma classes father agreed took day day class junior learned stop asking questions loved practiced hours got home	PERSON asked his father if he could sign up for MMA classes . His father agreed , and took him that very day . On the first day of class , Junior learned Brazilian PERSON PERSON . He was immediately hooked , and could n't stop asking questions . And he loved it so much , he practiced for hours once he got home .
had gotten speeding ticket scared tell parents information published paper parents found citation got trouble telling parents	PERSON had gotten a speeding ticket . He was scared to tell his parents . The information was published in the local paper . PERSON 's parents found out about the citation . He got in trouble for not telling his parents .
needed do load laundry added clothes soap washer minutes heard banging saw bubbles realized had put dish soap laundry soap felt making mistake	PERSON needed to do a load of laundry . She added her clothes and some soap to the washer . A few minutes later , she heard a loud banging and saw bubbles . PERSON realized she had put dish soap in instead of laundry soap . She felt ridiculous for making such a silly mistake .
bought lipstick online manufacturer tried wearing date lips started swell had take lipstick	PERSON bought some new lipstick online . It was from a chinese manufacturer . She tried wearing it out on a date . After a while her lips started to swell up . PERSON had to take the lipstick off .
rode bike school went leave bike gone walked home school told parents bike missing parents called school bike	PERSON rode his bike to school . When he went to leave , the bike was gone . PERSON walked home from school . He told his parents his bike was missing . PERSON 's parents called the school about the bike .
man looked cupboard plates man did dishes put dishes forgot had looking	The man looked in the cupboard . There were no clean plates . The man did the dishes . He put the dishes away . He forgot what he had been looking for .
thought played game basketball decided challenge friend agreed play practiced days game ended beating points	PERSON thought he played a good game of basketball . He decided to challenge his friend PERSON . PERSON agreed to play PERSON . PERSON practiced for a few days before the game . PERSON ended up beating PERSON by fifteen points .
wanted go vacation go researched vacation spots library talked travel agent trips decided buy tickets	PERSON wanted to go on vacation . He was n't sure where he should go . PERSON researched different vacation spots at the library . He talked to a travel agent about current trips . PERSON decided to buy tickets to LOCATION .
broke glass floor did clean glass mom stepped glass foot cut had get stitches hospital	PERSON broke a glass on the floor . She did not clean up the glass . Her mom stepped on the glass . Her foot was cut very badly . She had to get stitches at the hospital .
fixing bulb took time reach gave ladder changed bulb	PERSON was fixing a light bulb . It took a long time . He just could n't reach it . PERSON gave him a ladder . After that PERSON changed the bulb and was happy .
storm clouds approaching work building ran car get umbrella get umbrella ran building storm came shut door used umbrella rain left work hour	The storm clouds were approaching PERSON 's work building . He ran to his car to get his umbrella for later . PERSON was able to get the umbrella out and ran back inside the building . The storm came down as soon as he shut the door . PERSON used his umbrella in the rain when he left work in an hour .
man talked friend friend expressed frustration man sought help friend friend remained man decided friends temperament	The man talked to his friend . His friend expressed frustration . The man sought to help his friend . His friend remained frustrated . The man decided his friends temperament was frustrated .
loved candy thought handle day decided buy took home tried threw	PERSON loved sour candy . She thought she could handle it all . One day she decided to buy the most sour . When she took it home she tried it . It was so sour she threw it out .
walking barbed wire fence got pants caught ripped hole friends saw thought cool decided did mind ripped pants	PERSON was walking near a barbed wire fence . He got his favorite pants caught on it and they ripped a hole . He was very angry about it . His friends saw it and thought it was super cool . PERSON decided he did n't mind his ripped pants at all !
wanted start business decided coffee shop business researched planned got work open coffee shop got news city had denied permits	PERSON wanted to start a business . She decided a coffee shop would be a great business . She researched and planned and got to work . She was ready to open the coffee shop when she got bad news . The city had denied her permits !
notices see objects thinks need glasses gets pair glasses see see objects	PERSON notices that it is harder for him to see distant objects . He thinks he might need glasses . PERSON gets a pair of glasses . Now he can see very well . PERSON is glad that he can see distant objects easily now .
had fan needed replaced day started spinning control one blades flew hit forced replace	PERSON had an old fan . It needed to be replaced . One day it started spinning out of control . ONe of the blades flew off and almost hit PERSON . PERSON was forced to replace it finally .
owned bakery spent life savings open bakery nobody liked pastries sold bakery failing decided burn bakery see fail	PERSON owned a bakery . She spent her whole life 's savings to open the bakery . Nobody liked the pastries that PERSON sold . PERSON 's bakery was failing . PERSON decided to burn down the bakery instead of see it fail .
wanted sun tan look put bikini went beach laid sun putting sunscreen fell sun woke hours looking looked lobster	I wanted a nice sun tan so I could look more beautiful . I put my bikini on and went to the beach . I laid in the sun without putting any sunscreen on myself . I fell asleep in the sun and woke up 3 hours later . Instead of looking beautiful , I looked like a red lobster .
working yard built pergola tub wait vines grow going oasis had plans future yard	PERSON was working hard in his yard . He built a beautiful pergola over the hot tub . He could n't wait for the vines to grow over it . It was going to be a beautiful oasis . PERSON had big plans for the future of the yard .
mood work yelled people bus stop screamed bird realized eating pizza felt	I was in a bad mood . At work , I yelled at people . It the bus stop , I screamed at a bird . I realized that I was simply hungry . After eating a pizza , I felt happy again .
daugher left toys spread yard warned weather coming did listen warning storm hit blew toys neighborhood crying roaming neighborhood	My daugher left all of her toys spread out in the back yard . I warned her that bad weather was coming . She did not listen to my warning . When the storm hit , it blew her toys all over the neighborhood . Now she is crying and roaming the neighborhood for them .
coming addiction felt started affecting job told boss had believed kept job	PERSON was coming off of a bad addiction . He felt terrible . It started affecting his job . PERSON told his boss he had a cold . They believed him and he kept his job .
friend took rowboat lake halfway dropped oars stuck way get touch anyone hour boat came girls got rowed boat shore	PERSON and her friend PERSON took her rowboat out on the lake . Halfway across they dropped the oars ! They were stuck with no way to get in touch with anyone . After about an hour another boat finally came by . The girls got aboard and they rowed their boat to shore .
time take kids school bundles coats hats remembers forgot lunch rush kitchen throw lunch door go school bond	It was time to take the kids to school . The three of them were bundles in their coats and hats . Until the oldest remembers she forgot her lunch . I rush to the kitchen and throw together a lunch for her . Now out the door we go and school bond !
thanksgiving day charge turkey food table set checked turkey saw bottom cut pieces served	It was Thanksgiving day . PERSON was in charge of the turkey . All of the other food was ready and the table was set . When PERSON checked the turkey , he saw that the bottom was still raw . Instead , he just cut some pieces from the top and served those .
throwing birthday party friend sent invitations cake one arrived party have started realized wrote time invitations everyone arrived hour	PERSON was throwing a birthday party for his friend . He sent invitations and baked a cake . No one arrived when the party should have started . He realized he wrote the wrong time on the invitations ! Everyone arrived an hour later .
needed go store husband worked had go everything everything made home	PERSON needed to go to the store . Her husband worked early so she had to go even earlier . Everything was eerie and quiet while she was out . The positive was that everything was fast and easy . She made it back home so quickly .
women growing had looks school did care did need coasting looks wanting become model started doing music videos became video vixen time became made school knew	PERSON was always a beautiful women growing up , she had the looks . She was not good in school but she did n't care she did n't need it . She was coasting on her looks , wanting to become a model . She started doing music videos and became a video vixen in no time . She became famous and made it without any school like she knew .
eating milk cookies dipping cookies milk soaked broke half half fell bottom milk glass had use fork get	PERSON was eating milk and cookies . He was dipping the cookies in the milk . He soaked one too long and it broke in half . One half fell into the bottom of the milk glass . PERSON had to use a fork to get it back out .
waiter served food family gave place aunt offered salt said poured lot salt food tried eat tasted waiter had throw	The waiter served the food to my family . When she gave me my place , my aunt offered salt . Although I said no , she poured a lot of the salt onto my food . When I tried to eat it , it tasted too salty . The waiter had to throw it away for me .
man ate did care day fatness clogged arteries man had heart attack died tried bury coffin	Once , there was a very fat man . He ate too much and did n't care that he was fat . One day , his fatness clogged up his arteries . The fat man had a heart attack and died ! They tried to bury him , but he was too fat for the coffin .
bought pressure cooker decided make rice filled cooker rice water left room panicked lid exploded cooker rice had swelled caused explosion	I bought a new pressure cooker . I decided to make rice in it . After I filled the cooker with rice and water , I left the room . I panicked when the lid exploded off the cooker . The rice had swelled and caused the explosion .
wanted learn sing auditioned sing church choir director said voice tenor learned read sheet music singer joined choir	I wanted to learn how to sing better . I auditioned to sing for my church choir . The director said my voice was first tenor . I learned how to read sheet music . I am better singer now than I was before I joined the choir .
loved go beach decided spend afternoon beach dug toes sand watched ocean waves spent afternoon relaxing beach	PERSON loved to go to the beach . He decided to spend his afternoon at the beach . He dug his toes into the sand . He also watched the ocean waves . PERSON spent the entire afternoon relaxing at the beach .
sat class classmates staring clock snack time waited waited bell rang sprang front room line food	PERSON sat in class with her classmates staring at the clock . It was almost snack time . PERSON waited and waited . When the bell rang she sprang to the front of the room . Because she was so quick she was the first in line for food .
changing contact lenses dropped floor looked took time find time got contact lens	PERSON was changing his contact lenses . He accidentally dropped one on the floor . He looked around everywhere for it . It took him a long time to find it . By the time he finally got it the contact lens was too dry .
went spend day fun sun tried rides wanted try roller coaster line waited hour time came sat anticipation ride lasted seconds end exhilarated	PERSON went to the fair to spend a day of fun in the sun . She tried a few rides but really wanted to try the new roller coaster . There was a long line and she waited an hour . When her time came , she sat down with anticipation . The ride lasted thirty seconds , but at the end , she was exhilarated .
had list chores complete day started sweeping floors mopped kitchen bathrooms wiped surfaces find finished laid couch took nap	PERSON had a list of chores to complete that day . He started by sweeping the floors . Next , he mopped the kitchen and bathrooms . Lastly , he wiped down all the surfaces he could find . After PERSON finished , he laid on the couch and took a short nap .
had allergies cleaning house dusted fans baseboards began sneeze had eyes	PERSON had bad allergies . She was cleaning her house . PERSON dusted her fans and baseboards . They were very dusty . PERSON began to sneeze and had watery eyes .
opened door ice cream parlor knew product wanted saw flavor sparkled case drawn floating display case requested taste test buying ice cream flavor	PERSON opened the door to the ice cream parlor . He knew what he product he wanted until he saw it . The new flavor sparkled enticingly in the case . PERSON was drawn to it , floating effortlessly to the display case . He requested a taste test before buying the new ice cream flavor .
parents told clean basement going job felt asked friends help hesitated promised play xbox exchange everyone helped playing video games	PERSON 's parents told him to clean up the basement . It was going to be a big job and PERSON felt overwhelmed . He asked his friends for help but they hesitated . PERSON promised they could play with his Xbox in exchange . Everyone helped and soon they were all playing video games together .
wanted learn dance college called friend mine teach dancer taught everything knew dancing made dancer	I really wanted to learn how to dance in college . So I called up a friend of mine to teach me . He was a professional dancer and was very good . He taught me everything he knew about dancing . It made me better and now I am also a really good dancer .
took dog walk dog got boy chased dog caught dog leash boy returned dog	PERSON took her dog for a walk . The dog got away from her . A young boy chased after the dog . He caught the dog 's leash . The boy returned the dog to PERSON .
had lot work do computer had windows had screen space left bought computer monitor monitor allowed	PERSON had a lot of work to do on his computer . So he had several windows open . He hardly had any screen space left . So he bought a second computer monitor . PERSON 's second monitor allowed him to be so much more productive .
dad decided go meet rock wall put harnesses started climbing had ton fun raced dad top ended winning	PERSON and her dad decided to go meet at a rock wall . The two put their harnesses on and started climbing . PERSON had a ton of fun . She raced her dad to the top . She ended up winning .
knew baby born felt water break told husband angel angel rushed hospital went labor hours hours baby boy born	PERSON knew her baby was ready to be born any second . She felt her water break and told her husband , Angel . Angel rushed them to the nearest hospital . PERSON went into labor for more than two hours . Eventually four hours later , their baby boy was born .
feeling wanted see family visit terms family decided father lived visited father felt	PERSON was feeling very sad lately . He wanted to see some family but was n't really sure who to visit . He was n't on the best of terms with his family anymore . He finally decided on his father , who lived far away . When PERSON visited his father he felt much better !
husband mother asked talk sat porch beer hand began telling childhood abused father numbed warned turn	My husband 's mother asked to talk to me alone . She sat on the porch with a beer in her hand . She began telling me about his childhood . She was severely abused by his father . I was numbed as she warned me that he could turn out the same .
kia had wear glasses day school had forgotten order contacts knowing mocked kids surprise kids did seem care kia relieved had worried nothing	Kia had to wear glasses on her first day of high school . She had forgotten to order contacts and was all out ! She was miserable , knowing she 'd be mocked by the other kids . But to her surprise , the other kids did not seem to care . Kia was relieved that she had worried for nothing !
had friend wanted set date friend said guy day met man coffee shop went date discovered guy got married summer	PERSON had a friend who wanted to set her up on a blind date . Her friend said the guy would be perfect but PERSON was hesitant . One day she met a handsome and friendly man at the coffee shop . They went on a date and discovered he was the same guy . The two got married that summer .
years toddlers loves play today played rain danced puddles got took shoes went	PERSON is three years old . Like most toddlers , he loves to play outside . Today we played outside , despite the rain . We danced in puddles and got muddy . Then we took off our shoes and went back inside .
sat class got went bathroom came sat noticed pen missing did want accuse pulled	PERSON sat in class . She got up and went to the bathroom . When she came back she sat down . She noticed her pen was missing . She did n't want to accuse so she pulled out a new one .
finished reading murder mystery featured lot stores landmarks loved lived years read book toured area see locations got excited news make movie	I just finished reading LOCATION , a murder mystery . The novel featured a lot of local stores and landmarks . I loved the novel , as I lived in LOCATION for thirty years . After I read the book I toured the area to see the locations . Now I got excited by the news they might make a movie .
needed clean computer case build took rag sink cleaned crevice case dried case hairdryer case used	PERSON needed to clean his computer case before he could build it . He took a rag and wet in under the sink . Then , he manually cleaned every crevice of the filthy case . Next , PERSON dried the case with a hairdryer . The case was now clean and ready to be used !
archer ended entering field archery tournament needed bulls eye win tournament managed hit bulls eye won tournament awarded gold medal	PERSON was always a great archer . He ended up entering a local field archery tournament . He needed one more bulls eye to win the tournament . He managed to hit the last bulls eye and won the tournament . He was awarded with a gold medal .
working car having trouble getting car start brother mechanic got brother come brother got car start	PERSON was working on a car . He was having trouble getting the car to start . PERSON 's brother was a mechanic . He got his brother to come over . PERSON 's brother got the car to start .
got bologna sandwiches lunch day complained wife bologna showed images children world put things perspective realized get bologna day	PERSON got bologna sandwiches in his lunch every day . He complained to his wife that he was sick of bologna . But then she showed him images of hungry children all over the world . That put things in perspective for PERSON . He realized he was lucky to get bologna every day !
noise room speaker blasting rock music tried figure turn get everyone covered ears left room	There was a loud noise in the room . The speaker was blasting rock music . PERSON tried to figure out how to turn it down . She could n't get it any quieter . Everyone covered their ears and left the room .
working cashier grocery store customers made fun making money day decided had quit job go school	I was working as a cashier for a grocery store . All of the customers were rude and nasty . They made fun of me for making little money . One day I decided that I had enough . I quit the job so I could go back to school .
had toy yoyo wanted learn do lots trips watched youtube videos hour learned do things	PERSON had a new toy . It was a yoyo ! He wanted to learn how to do lots of trips . He watched youtube videos on it for an hour . He quickly learned how to do some really cool things !
friends drinking bar dd says lets go end driving hung beach hours drove	Some friends and I were drinking at the bar . The DD jokingly says , `` lets go to LOCATION . '' We end up driving to LOCATION . We hung out at the beach for 2 hours . Then we drove back to LOCATION .
learning drive brother car brother driving brother thought talking stop light brother got took driving had learn drive someone	PERSON was learning to drive in his brother 's car . His brother was very critical of his driving . PERSON 's brother thought he was talking too much and inattentive . At a stop light , PERSON 's brother got out and took over driving from PERSON . PERSON had to learn how to drive from someone else .
coworker used drink grand marnier pineapple juice wife looking drink try tonight had grand marnier pineapple juice did find pineapple juice said drink fun	My coworker used to drink Grand Marnier and pineapple juice . My wife was looking for a drink to try tonight . She had Grand Marnier but no pineapple juice . She did find orange pineapple juice and mixed that . She said the drink was fun .
sue entered nacho eating contest nachos food thought do sue started pace upped ante sue ate pounds nachos did win	Sue entered a nacho eating contest . Nachos are her favorite food so she thought she could do well . Sue started off slow to pace herself . She then upped the ante . Sue ate 15 pounds of nachos but did not win .
wife had decided visit january christmas took surprise give gifts take vacation decided give gifts year	My wife and I had decided to visit the LOCATION LOCATION in January . Christmas took us totally by surprise . We could give gifts or take vacation . We finally decided to give gifts . There is always next year .
husband own boat take boat fishing night sunset decided come motor died had paddle mile shore arrived hours	My husband and I own a small boat . We often take the boat fishing in LOCATION . One night it was close to sunset and we decided to come in . The motor died so we had to paddle over one mile back to shore . We arrived safely after 2 hours .
wanted buy wife something got print purse opened did like idea ostrich harmed said return	PERSON wanted to buy his wife something special . He got her an ostrich print purse . She opened it and was speechless . She did n't like the idea of an ostrich being harmed . PERSON said he would return it .
wanted wonderwoman halloween went costume shops looking costume shops sold decided make woman costume costume	PERSON wanted to be Wonderwoman for Halloween . She went to five costume shops looking for the costume . All of the shops were sold out . PERSON decided to make her own Wonder Woman costume . The costume was very bad .
wife retiring weeks coworkers found gave wife tickets sox game going son	My wife is retiring in three weeks . One of her coworkers just found out . She gave my wife two tickets to a Red Sox game . She is going with my son . I was happy for her .
decided heat food microwave tossed placed timer minutes minute container splashed place felt burning sensations pain went	PERSON decided to heat some of his food in the microwave . He tossed it inside and placed the timer for 3 minutes . After a minute , the whole entire container splashed all over the place He felt several burning sensations . Eventually , the pain went away after by
work day got nose ran back store grabbed towel cleaning made nose bleeding looked saw line people waiting ran got work	PERSON was at work one day , when he got a bloody nose . He quickly ran to the back of the store and grabbed a towel . After cleaning up , he made sure his nose was n't bleeding anymore . He looked outside , and saw a line of people waiting for him . PERSON quickly ran back and got back to work .
woke prepare day school got campus girl greeted introduced commented looks had conversation exchanged numbers addition asked day	I woke up to prepare for my first day of school . When I got on campus , this girl greeted me . She introduced herself and commented on my looks . We had a small conversation and exchanged numbers . In addition , she asked me out the next day .
grade friend made deal agreed have girlfriends hang do guy stuff weeks found had broken agreement found holding hands recess	In the sixth grade , my best friend PERSON and I made a deal . We agreed that neither of us would have girlfriends . We would only hang out with each other and do guy stuff . Two weeks later I found out that PERSON had broken our agreement . I found him holding hands with PERSON at recess !
fell love stranger town strangers invited man move day left man note pick work did arrive did know stranger read	PERSON fell in love with a tall dark stranger in town . Though practically strangers , she invited the man to move in . One day , PERSON left her new man a note to pick her up after work . When he did n't arrive , PERSON was furious . She did n't know that the dark stranger could n't read .
enjoys baking friends basis decided enter competition fruit judges competition loved fruit won place competition	PERSON enjoys baking for her friends on a regular basis . She decided to enter a baking competition . PERSON baked a beautiful and delicious fruit tart . The judges at the competition loved her fruit tart . PERSON won first place at the baking competition !
woman went twentieth school reunion job having seen lot sitcoms decided doctor did everyone reunion	A woman went to her twentieth high school reunion . She was ashamed of her relatively un-prestigious job . Having seen a lot of sitcoms , she decided to fake being a doctor . Unfortunately , so did everyone else . It was a very , very awkward reunion .
enjoying wedding reception cousins stood began speaking cousin announced earning cheers annoyed cousin stealing attention did want seem did say anything	PERSON was enjoying her wedding reception . Suddenly one of her cousins stood and began speaking . The cousin announced that she was pregnant earning cheers . PERSON was annoyed at her cousin for stealing the attention . Still she did n't want to seem rude so she did n't say anything .
walking school hallway noticed poster read poster advertised track club meeting image throwing shot put flashed mind decided moment try team had working thought	PERSON was walking in the school hallway when he noticed a poster . PERSON read the poster which advertised a track club meeting . An image of himself throwing the shot put flashed across his mind . He decided at that moment to try out for the team . He had been working out , so his next thought was that he was ready .
yesterday end work shift cleaning store cleaning noticed woman sitting bench front watched lay bench vomited continued lay bench locked store left	Yesterday at the end of my work shift I was cleaning the store . After cleaning I noticed a woman sitting on the bench out front . I watched her lean over and lay down on the bench . She vomited all over and continued to lay on the bench . I quickly locked up the store and left .
hated co-worker got scheduled work co-worker crossed line got fight got fired	PERSON hated his co-worker . They never got along . They were scheduled to work together often . PERSON 's co-worker finally crossed the line . PERSON got into a fight with him and both got fired .
tennis player won awards playing tennis clubs school graduate college offered tennis scholarship adam accepted scholarship attended college	PERSON was a great tennis player . He won many awards playing tennis for clubs and at his school . PERSON was about to graduate . A college offered him a tennis scholarship . Adam accepted the scholarship and attended the college .
kept getting calls seemed pranking got tired blocked number did get calls looked online found 's guy does lot people	PERSON kept getting random calls They all seemed to be pranking him . He got tired of it and blocked the number . He did not get any calls anymore . He looked online and found it 's a guy who does that to a lot of people
playing hopscotch sidewalk saw wanted join played til sundown had fun	PERSON was playing hopscotch on the sidewalk . PERSON saw . She wanted to join . The two played til sundown . They both had so much fun .
eating sandwiches left room gone licked sandwich got realized did pay back smeared peanut butter sandwich vowed lick sandwich	PERSON and PERSON were eating sandwiches together . PERSON left the room and while he was gone PERSON licked his sandwich . When PERSON got back and realized what PERSON did , he was angry . To pay her back , PERSON smeared his peanut butter sandwich on PERSON . PERSON vowed never to lick his sandwich again .
saw van pull house man got handed roses boyfriend called say thank	PERSON saw a van pull up to her house . A man got out and handed her some roses . They were from her boyfriend . He was so sweet ! PERSON called him right away to say thank you .
wanted throw beach party friends sat table wrote needed party went stores bought items needed called invited friends wanted party threw beach party had time friends	PERSON wanted to throw a beach party for her and her friends . PERSON sat down at table and wrote down what she needed for the party . PERSON went to different stores and bought the items she needed . PERSON called and invited all the friends she wanted at her party . PERSON threw the beach party and had a good time with her friends .
yard becoming overrun weeds put gloves went picked weeds hours picked weeds yard looked	My yard was becoming very sloppy . It was overrun with weeds everywhere . I put on my gloves and went outside . I picked weeds for a few hours . After I picked the weeds , the yard looked much better .
loves elephants has wanted see elephant life honeymoon convinces wife go wife travel go tim see elephant	PERSON loves elephants . He has wanted to see an elephant in the wild his entire life . For his honeymoon , PERSON convinces his wife to go on safari . PERSON and his wife travel to LOCATION to go on safari . Tim is finally able to see an elephant up close .
wanted change diet decided vegan cut changing lifestyle	PERSON wanted to change her diet . She decided to be a vegan . She cut it all out . It was hard . But she was happy she was changing her lifestyle .
came lamented illness stayed home bed developed cough did have medicine called friend asked help friend brought bag lozenges hit spot	PERSON came down with a cold . She lamented her illness , and stayed home in bed . She developed a terrible cough , but did n't have the right medicine . PERSON called a friend and asked for help . Her friend brought her a bag of lozenges , which really hit the spot .
doctor appointments had phobia having blood drawn did like shots doctor intimidated does like going doctor	As an adult , PERSON was still afraid of doctor 's appointments . She had a phobia of having blood drawn . She did n't like shots either . Doctor 's intimidated her . She does n't like going to the doctor .
roommate used take showers leave water use had write note leave counter note asked take showers note takes showers	My roommate used to take long showers . She would leave no hot water for me to use . I had to write her a note and leave it on the counter . The note asked her to take faster showers . Ever since that note she takes very fast showers .
cloud man decided bring coat began rain man put coat coat protected rain	The cloud was grey . The man decided to bring a coat . It began to rain . The man put on the coat . The coat protected him from the rain .
city work needed rent car get options limited picked rental hated time	PERSON was in a new city for work . He needed to rent a car to get around . Unfortunately his options were limited . He picked the best of the worst . Still the rental was awful and he hated it the whole time .
wanted take bath bath playing games phone dropped phone bathtub panicked put phone rice rice dried phone use	PERSON wanted to take a bath . While in the bath she was playing games on her phone . She dropped her phone into the bathtub . PERSON panicked and put her phone in rice . The rice dried out the phone and she was able to use it again .
went fishing trip caught dozen bass caught nothing knew wanted bring fish home family gave fish caught frank have trip invited have dinner family	PERSON and PERSON went on a fishing trip together . PERSON caught over a dozen large bass and PERSON caught nothing . PERSON knew that PERSON wanted to bring some fish home to his family . He gave all of the fish he caught to Frank who was glad to have them . After the trip PERSON invited PERSON to have dinner with his family .
took dog dog park having fun dog started trying attack had intervene took dog home	PERSON took his dog to the dog park . He was having fun at first . Then another dog started trying to attack it . PERSON had to intervene . He took his dog home .
wanted go birthday went friends club dance night dancing went friends eat had time	PERSON wanted to go out for her birthday . She went out with her friends to the club . She dance the night away . After dancing she went with her friends to eat . She had a great time out .
mornings drinking coffee lots caffeine helped relax had cups today had coworkers pitched bought	PERSON was always irritable in the mornings . Drinking coffee with lots of caffeine helped him relax . He always had two cups . Today he only had one . His coworkers pitched in and bought him another .
years wanted find traveled studied ashram studied thought lot wanted end months flew went college did	PERSON was 20 Years old , and wanted to find herself . She traveled to LOCATION , and studied in an ashram . She studied , and thought a lot about who she wanted to be . At the end of two months , she flew back to the LOCATION . She went back to college , and did well for herself .
grade sits front class day uses safety scissors cut lock hair school treats incident assault weapon school suspends days	PERSON is in third grade . PERSON sits in front of him in class . One day he uses his safety scissors to cut a small lock of PERSON 's hair The school treats the incident as an assault with a weapon . The school suspends PERSON for 3 days .
wanted keep dog found knew needed go home owner found dog had tags felt dog knew had find home	PERSON wanted to keep a loose dog she found . But she knew he needed to go home to his owner . However she found the dog had no tags . She felt responsible for the loose dog . She knew she had to find him a safe , new home .
mac started writing editorial school paper called ask mac students wrote ask things offered advice mac loved writing ask mac	Mac started writing an editorial in the school paper . It was called Ask Mac . Students wrote in to ask him things . Then he offered salient , helpful advice . Mac loved writing Ask Mac !
had acne self esteem hated looked mom took dermatologist skin cleared time	PERSON had terrible acne . It was bad for her self esteem . She hated how she looked . Her mom took her to a dermatologist . Her skin cleared up in no time .
trial jury watched move knew thought tried look jury found	PERSON was on trial . The jury watched his every move . PERSON knew they thought he was guilty . He tried to look nice and pleasant . The jury found him guilty anyway .
wife sent get groceries went store got sidetracked wound buying things did need wife upset	PERSON was always impulsive . His wife sent him to get groceries . PERSON went to the store and got sidetracked . He wound up buying several things he did n't need . His wife was upset with him .
bragging track runner bragging became friends track team track girls challenged race ended beating race second bragged running	PERSON was always bragging about how she was the best track runner . The bragging became obnoxious to all of her friends on the track team . So one of the track girls , PERSON , challenged PERSON to a 50m race . PERSON ended up beating PERSON in the race by a full second . PERSON never bragged about her running again .
playing front yard trips something looks see digs finds chest gold	PERSON is playing in her front yard . She trips over something . She looks to see what it is . She digs it up . She finds a big chest with gold inside .
son got excited saw fireflies movie did believe insects light explained country decided take drive find eyes grew one spotted	PERSON 's son got really excited when he saw fireflies in a movie . He did n't believe that there are insects that really light up . She explained that they are more common out in the country . They decided to take a little drive to find some . His eyes grew wide at the first one he spotted .
oatmeal decided leave kitchen while came minutes overflowed stove left kitchen time cooked oatmeal	PERSON was cooking oatmeal . And he decided to leave his kitchen for a while . He came back 5 minutes later . But it overflowed onto the stove . PERSON never left the kitchen the next time he cooked oatmeal .
grocery store husband asked pick juice bought juice groceries got home checked juice had gotten flavor	PERSON was at the grocery store . Her husband asked her to pick up some juice . She bought the juice along with the regular groceries . When she got home , he checked the juice out . Unfortunately , she had gotten the wrong flavor .
eve year spilled juice carpet afraid getting trouble covered bean bag chair eve forgot did mom vacuuming moved chair horrified find mold juice spilled	Eve , a 12 year old , spilled orange juice on the carpet . Afraid of getting in trouble , she covered it with a bean bag chair . Eve forgot about what she did . While her mom was vacuuming , she moved the chair . She was horrified to find mold where the juice was spilled .
wanted take guitar lessons thought gift parents got guitar	PERSON really wanted to take guitar lessons . She was quite nervous about it actually . She thought she would be terrible . As a gift however her parents got her a guitar . She was very thankful .
had sampled mom wine night mom had caught grounded morning woke hangover thought punishment grounding vowed drink alcohol	PERSON had sampled her mom 's wine last night . Her mom had caught her and grounded her . But the next morning , PERSON woke with a terrible hangover . She thought that was a far worse punishment than the grounding . PERSON vowed never to drink alcohol again !
part job train people restaurant today had train hostess phones greeting guests decided cut job fired vowed find job	Part of PERSON 's job was to train all the new people at the restaurant . Today PERSON had to train PERSON to be the hostess . She was shy on the phones and was n't polite greeting guests . PERSON decided that she was not cut out for this job so he fired her . PERSON was sad and vowed to find a job she is good at .
house pothole knew hole avoided people did know hit hole called city pothole crews came fixed pothole day	Outside , PERSON 's house was a huge pothole . PERSON knew about the hole and avoided it everyday . Other people did not know and hit the hole often . PERSON called the city about the pothole . Crews came and fixed the pothole the next day .
went business trip got apartment wife found note refrigerator wife had left filed divorce	PERSON went on a business trip . When he got back his apartment was half empty . His wife was nowhere to be found . There was a note on the refrigerator . His wife had left and filed for divorce .
kid loves music starts write words song records song studio made song	PERSON is a kid . He loves music . He starts to write down words to a song . He records his song in the studio . PERSON made his very first song .
needed move couch home home flights stairs ground enlisted help friends grunting shoving got house did match room decided content	I needed to move my new couch into my home . Unfortunately , my home is three flights of stairs above the ground . I enlisted the help of two friends . With much grunting and shoving , we got it into my house . It did n't match my room well , but I decided to be content .
family has gone vacation years decide go swim surf have time family took vacation	The PERSON family has n't gone on vacation in years . They decide to go to LOCATION LOCATION together . In LOCATION LOCATION they swim and surf . They have a great time . The PERSON family is happy they took a vacation .
playing dodgeball pe had taunting girl team looking threw ball nailed face apologized help laugh bit	PERSON was playing dodgeball in PE . He had been taunting a girl on the other team . When he was n't looking , she threw the ball . It nailed him right in the face , startling him . She immediately apologized but she could n't help but laugh a bit .
got t shirt day wore wanted washed decided put washer washed tried dismay shirt had	PERSON got a new t shirt the other day . Before she wore it , she wanted it washed . PERSON decided to then put it in the washer . After it was washed she tried it on . To her dismay , the shirt had shrunken majorly .
doing science experiment experimenting frog giving drugs see react frog died expected	PERSON was doing a science experiment . She was experimenting with a frog . She was giving it drugs to see how it would react . The frog died . It was n't what she expected .
asked barbie doll birthday got imitation pals invited play dolls teased doll walked home tossed doll bushes	PERSON asked for a Barbie doll for her birthday . Instead , she got a cheap imitation . PERSON 's pals invited her over to play dolls . They teased PERSON about her fake PERSON doll . As PERSON walked home , she tossed the doll in some bushes .
wanted do something veteran day went shelter veterans helped feed felt end day	PERSON wanted to do something special for Veteran 's Day . He went to the homeless shelter . There were many homeless veterans there . He helped feed 200 of them . PERSON felt very good at the end of the day !
went root canal dentist said help first had remove tongue rings had had years remove	PERSON went in for a root canal . Then the dentist said he could not help her yet . First she had to remove all her tongue rings . PERSON had had them in for Years ! They were very difficult to remove !
decides wants try picking apples orchard brings basket collect apples drives orchard orchard picks apples takes apples home eat time went apple picking	PERSON decides that he wants to try picking apples at the orchard . He brings a basket to collect the apples and drives to the orchard . At the orchard he picks many delicious apples . He takes the apples home with him to eat another time . PERSON is very happy that he went apple picking .
made mistakes asked help fixing people refused help stopped caring mistakes helped make mistakes	PERSON made mistakes . He asked for help fixing them . People refused to help . PERSON stopped caring about mistakes . That helped him not make as many mistakes .
sunday sister-in-law dropped visits talked time left meatloaf gift had meal night	On Sunday my sister-in-law dropped by . She very rarely visits us . We talked for some time . She left us some meatloaf as a gift . We had a nice meal that night .
marriage cheated wanted revenge put sugar tank slashed tires divorced day	PERSON was in an unhappy marriage with PERSON . PERSON cheated on her very badly . PERSON wanted revenge on him . So , she put sugar in his tank and slashed his tires . He divorced her the next day .
begged mom puppy mom gave fern mom said took care fern get dog forgot water fern week has practice responsibility cactus notice	PERSON begged her mom for a puppy . PERSON 's mom gave her a fern instead . Her mom said that if PERSON took good care of the fern , she 'd get a dog . PERSON forgot to water the fern for a whole week . PERSON has to practice responsibility with a cactus until further notice .
bit going school reunion feared group girls made fun put brave face neared reception hall relieved discover girls had gotten fat fat made girls had time	PERSON was a little bit nervous about going to her high school reunion . She feared that group of girls who made fun of her would be there . However , she put on a brave face as she neared the reception hall . She was relieved to discover every one of those girls had gotten fat . Being fat made the girls much friendlier and PERSON had a great time .
family came aunt house played hide go seek turn look everyone looked shower curtain pulled curtains ended pulling sister hair	My family came over to my aunt 's house . We played hide and go seek . It was my turn to look for everyone . When I looked in the shower curtain , I pulled the curtains . Overall , I ended up pulling my sister 's hair since she was in there .
wanted phone christmas anything unwrapped iphone box opened find silver bracelet mother had trying trick box had christmas	PERSON wanted a phone for Christmas more than anything . When she unwrapped her last present there was an iphone box . She eagerly opened it only to find a silver bracelet inside . Her mother had n't been trying to trick her , it was just a box she had . PERSON was very disappointed that Christmas .
snowflake drifted sky ground saw happen window went collect flake found waited flake arrive	A snowflake drifted from the sky to the ground . PERSON saw this happen from a window while inside . He went outside to collect it . That flake was nowhere to be found . PERSON waited for the next flake to arrive .
actor play rehearsal forgot lines looked stage director worry director gave look felt had studied lines	PERSON was an actor in a play . During rehearsal , he forgot one of his lines . He looked up at the stage director with worry . The director gave him a frustrated look . PERSON felt ashamed that he had n't studied his lines very well .
friend asked hang became puts work inconvenience see did hesitate say 've said past understood left end remained friends	When my friend asked me to hang out , I became furious . She puts my work at an inconvenience just to see her . I did n't hesitate to say no since I 've only said yes in the past . She completely understood and left . In the end , we still remained friends .
did snow did expect blizzard pipes froze burst blizzard one get fix water flooded basement prayed blizzard did	It did n't snow often in LOCATION , so PERSON did n't expect a blizzard . Her pipes froze over until one of them burst . Because of the blizzard , no one could get out to fix it . Water flooded her basement . PERSON prayed that the blizzard did n't last long .
pilot flying plane rain storm saw rainbow decided see ended rainbow became followed did give end rainbow parking lot cleaners pilot disappointed did have end	A pilot was flying in a plane after a gentle rain storm . He saw a rainbow and decided to see where it ended . The rainbow became fainter as he followed it but he did n't give up . The end of the rainbow was a parking lot outside a dry cleaners . The pilot was disappointed that it did n't have a more meaningful end .
looking socks online found pair reviews decided risk quality disappointment socks quality left review socks online	PERSON was looking for socks online . He found a pair with no reviews . Since it was so cheap he decided to risk the quality . To his disappointment , the socks were poor quality . He left a bad review for the socks online .
considered drinker bar night stranger challenged drinking challenge accepted won got ego drinking problem	PERSON considered himself a big drinker . He was at a bar one night . A stranger challenged him to a drinking challenge . PERSON accepted and won easily . PERSON got an even bigger ego about his drinking problem .
winter shape wanted get shape summer started working eating time got looked got compliments	It was winter and PERSON was out of shape . He wanted to get in better shape for summer . He started working out and eating better . By the time it got warm PERSON looked much better . He got several compliments .
went doctor doctor told decided do something started bringing salads work eating sandwiches month had lost pounds	PERSON went to the doctor . The doctor told him he was overweight and unhealthy . PERSON decided to do something about it . He started bringing salads to work instead of eating large sandwiches . A month later , PERSON had lost 15 pounds .
friend had go jail days given midnight turn dropped night called come pick hours days	My friend had to go to jail for two days . He was given until midnight to turn himself in . I dropped him off at 10:30 that night . At 12:30 am he called me to come pick him up . He was there for less than 3 hours but it was over 2 days .
born eye age doctors said give eye sight had tissue donation eye operation terrified waking depth perception feeling life	PERSON was born blind in one eye . At age 14 , doctors said could give her blind eye sight . They had a matching tissue donation for PERSON 's eye . The operation , understandably , terrified her . But waking to depth perception was the best feeling of her life !
loved watching sports sports bars decided get tray wings watch season game showed bar day had used season schedule days	PERSON loved watching sports at sports bars . He decided to get a tray of wings and watch the season 's first game . PERSON showed up at the bar on the appropriate day . He was the only one there . He had used the last season 's schedule , and was three days early .
girls mystery tried make bought flowers chocolates found girl appreciated became girlfriend boyfriend result	To PERSON girls were always a mystery . He always tried to make them like him but never could . He bought them flowers and chocolates . Eventually he found a girl who appreciated how sweet he was . The two of them became girlfriend and boyfriend as a result .
rich came home vacation horrified reason house smelled wandered looking source smell found gallon milk table opened windows dissipate smell	Rich came home from vacation and was horrified . For some reason , his house smelled really bad ! He wandered around , looking for the source of the smell . He found a gallon of sour milk on the table . PERSON opened windows to dissipate the smell .
went school learned flavors home made chicken soup family played kinds seasonings spices soup did taste right mom added salt soup became	PERSON went to culinary school and learned about exotic flavors . Back home , she made chicken soup for her family . She played with all kinds of seasonings and spices . But the soup just did n't taste right . Then her mom added some salt - and the soup became perfect !
going cruise friends had gotten brand stereo system car played tunes blast got pulled police police officer gave warning playing music	PERSON was going on a cruise with his friends . He had just gotten a brand new stereo system in his car . He played his tunes on full blast . All of a sudden , he got pulled over by the police . The police officer gave him a warning for playing his music too loud .
year takes partner place moving book flights place met place bar moved year arrived find place shut star restaurant worked	Every year , PERSON takes his partner to the same place . Despite moving away , he will book flights to the place they first met . This place was a bar in LOCATION but they 'd moved to the LOCATION . This year , they arrived to find the place was shut down . There is now a 5 star restaurant there , so it worked out for the best .
afternoon nothing eat house had money started looking change couch cushions get change dollar menu	PERSON was really hungry one afternoon . There was nothing to eat at the house . He had almost no money . PERSON started looking for change between couch cushions . He was able to get enough change for the dollar menu .
day man climbed tree police called man refused get tree waited hours man came tired	One day a crazy man climbed into a tree . The police were called . The man refused to get down from the tree . They waited for hours . Finally the man came down because he was tired .
felt getting afford miss days work decided go work kept getting cold blown went work got people	PERSON felt he was getting sick . He could n't afford to miss any days at work . He decided to go to work and kept getting worse . Eventually his cold was full blown . PERSON still went to work and got several other people sick .
walking street day sees cat stuck tree tries call cat does come climbs tree rescues cat	PERSON is walking down the street one day . He sees a cat stuck in a tree . He tries to call it down . The cat is scared and does n't come to him . He climbs the tree and rescues the cat himself .
had night had attend magazine party got hair makeup done walked tripped dress fall	PERSON had a busy night . She had to attend a magazine party . She got her hair and makeup done for it . As she walked in though , she tripped on her dress . Her fall was very embarrassing for her .
enjoyed meditation wanted reach states meditation had heard zen learned learned zen applied techniques improved meditation	PERSON enjoyed meditation . He wanted to reach deeper states of meditation . He had heard about zen but never learned about it . He learned about zen . He applied the techniques and it improved his meditation .
liked working computers started business working computers accepted work started overwhelmed work hired person help finish computers	PERSON liked working on computers . PERSON started his own business working on computers . PERSON accepted too much work when he started . Now PERSON is overwhelmed with too much work . PERSON hired a second person to help him finish all the computers .
went study recorder came banded group friends played music became sensation milieu	PERSON went to LOCATION to study the recorder professionally . When she came back , she was very good . She banded up with a group a friends . And they played baroque music together . They became a sensation in their milieu very fast .
going work has take elevator car elevator stops working calls help firemen rescue ted elevator	PERSON is going home from work . He has to take the elevator to his car . Suddenly the elevator stops working . PERSON calls for help . The firemen safely rescue ted out of the elevator .
decided stop shaving figured having beard trouble work did forced go shaving	PERSON was pretty lazy . He decided to stop shaving . He figured having a beard was less trouble . Unfortunately his work did n't like it . PERSON was forced to go back to shaving .
aunt bought brother ducklings easter kids see play day hurried aunt house play arrival realized ants lesson pet death	My aunt bought my brother and I ducklings on Easter as kids . We were so excited to see and play with them daily . The next day , we hurried over to my aunt 's house to play with them . Upon arrival , we soon realized that they were dead with ants on them . It was my first lesson in pet death , and we were so sad .
mom lived time wanted talk had pay money did call mother died paid thousands dollars take plane regretted having spent dollars talk	PERSON 's mom lived very far . Every time he wanted to talk to her he had to pay extra . As he was very close to his money , he did n't call her often . When his mother died , he paid thousands of dollars to take a plane . And he regretted not having spent a few dollars to talk to her .
had collection dolls bedroom had doll called day school pet dog skippy found skippy chewed arms devastated finding chewed doll	PERSON had a large collection of dolls in her bedroom . PERSON had a favorite doll she called PERSON . One day while PERSON was at school her pet dog Skippy found PERSON . Skippy chewed off one of PERSON 's arms . PERSON was devastated after finding her chewed up doll .
went diner ordered breakfast decaf coffee server looked poured coffee sipped coffee knew gave coffee came food called server hung head shame gave tip	PERSON went to the diner and ordered breakfast and decaf coffee . His server looked guilty as she poured him coffee . PERSON sipped the coffee and knew that she gave him regular coffee . When she came back with his food he called her out . The server hung her head in shame and PERSON gave her a low tip .
had opera excited see happen arrived opera house date took seat show began believe sounded	PERSON had never been to an opera before . He was excited and curious to see what would happen . He arrived at the opera house with his date . He took his seat and the show began . He could n't believe how amazing it sounded , he was hooked .
going vacation taking family beach had time spent lot time sand family returned home had clean sand car	PERSON was going on vacation . He was taking his family to the beach . They had a great time but spent a lot of time in the sand . PERSON and his family returned home . He had to clean all the sand from his car .
loved everything rainy liked smell sound lived west coast city summer visited got desire	PERSON loved everything about the rainy . She particularly liked the smell and sound of it . But she lived in a dry west coast city . One summer she visited LOCATION . There she got all the rainy she could possibly desire .
friend friend met girl girl had friend wanted hang hung friend help	PERSON was out with his friend . The friend met a cute girl . The girl had a fat friend . They all wanted to hang out . PERSON hung out with the fat friend to help .
made sandwich eat had knock door put sandwich coffee table forgot dog roaming came dog had eaten sandwich	PERSON made a sandwich . As he was about to eat , he had a knock on the door . PERSON put his sandwich on the coffee table . He forgot his dog was roaming free . When PERSON came back , his dog had eaten his sandwich .
waiting restaurant server made drinks brought ticket dinner gave tip	We were waiting at a restaurant . Our server was very kind . She made sure our drinks were full . She brought us our ticket for dinner . We gave her a great tip .
date showered wanted smell cologne made cover part date turned broke hives had go	PERSON was nervous about his big date . He showered and wanted to smell nice with cologne . He made sure to cover every vital part . Unfortunately his date turned out to be allergic . She broke out in hives and had to go home early .
girl did have clothes nothing fit well went mall found salesperson salesperson picked dress fit decided buy	PERSON was a fat little girl . She did n't have any nice clothes because nothing fit her well . She went to the mall and found a nice salesperson . The salesperson picked out a pretty dress for PERSON . It fit her perfectly and so she decided to buy it .
friend ate burger had feeling stomach eating hours fell went doctor cure illness doctor gave antibiotics get	My friend PERSON ate a burger . He had a weird feeling in his stomach after eating it . Several hours later he fell ill . He went to the doctor to cure his illness . His doctor gave him antibiotics to get better .
kept getting calls people calls came hours night day changed number problem stopped gives number felt loved received calls	PERSON kept getting calls from random people . The calls came in all hours of the night and day . PERSON changed her number and the problem stopped . She is very careful about whom she gives her number to . Ironically , she felt more loved when she received all the calls .
sat bag popcorn turned tv ate handful tried find something watch found tv show watch looked bag	I sat down with a bag of popcorn . I turned on the tv . I ate a handful while I tried to find something to watch . When I finally found a tv show to watch , I looked into the bag . It was empty .
arrived work macy put coat room wanted go break went grab coat surprise coat gone informed management coat taken area coat found offered replace	PERSON arrived to work at Macy 's and put her coat in the back room . She wanted to go outside for break so she went to grab her coat . To her surprise her coat was gone . PERSON informed management her coat was taken from her area . When her coat was n't found they offered to replace it for her .
thought whenever friends dress visiting mall friends spotted agent agent turned recruiter modeling company working model brand	PERSON never thought she was very attractive . Whenever she was out with friends she would dress down . While visiting a local mall with friends she was spotted by an agent . This agent turned out to be a recruiter for a modeling company . She is now working as a model for a major retail brand .
walking saw straw cat decided pet cat bit got went doctors	PERSON was walking around outside . He saw a straw cat . He decided to pet it . The cat bit him . He got very nervous and went to the doctors .
closed door waited snuck jumped corner terrified caused tackle tickle cried love thing	PERSON closed a door on PERSON . PERSON waited , then snuck up on PERSON . PERSON jumped out of the corner and terrified him . That caused PERSON to tackle PERSON and tickle him until he cried . Brotherly love is a funny thing !
hated lugging suitcases storage trip had luggage room built house loved having designated spot luggage pack retrieve bags room made organized	PERSON hated lugging the suitcases out of storage for each trip . She had a luggage room built in her new house . She loved having a designated spot for the luggage . When she was ready to pack , she would just retrieve her bags . The new room made her much more organized .
day took dog park walk walking runner runs going sprinted chase runner chased minutes caught sat tree enjoyed shade run	One day PERSON took his dog PERSON to the park for a walk . While walking , a runner runs right past them going really fast . PERSON sprinted off to chase the runner . PERSON chased PERSON for ten minutes before he finally caught him . The two sat near a tree and enjoyed the cool shade after a long run .
today birthday woke bed decided make breakfast heard knocks doors got seat walked door opened door family front	Today was my Birthday . I woke up from my bed and decided to make breakfast . Afterwards , I heard several knocks on the doors . I got up from my seat and walked towards the door . When I opened the door , some of my family were in the front .
friday night friends play basketball friday went gym play ball lot people showed did know got know playing have lot friends play basketball	Every Friday night me and my friends play basketball . Last Friday we went to the local gym to play ball . A lot of new people showed up who I did n't know . I got to know them while we were playing . Now I have a lot of new friends to play basketball with !
wanted bikini bring summer camp mom tried coax get one-piece prevailed packed bikini camp lake thrilled girl bikini diving platform saw made sense	PERSON wanted a bikini to bring to summer camp . Her mom tried to coax PERSON to get a practical one-piece . PERSON prevailed and packed the bikini for camp . At the lake , she was thrilled to be the only girl in a daring bikini . After diving off the platform , PERSON saw why a one-piece made sense .
friends love skateboard has tried learn months made progress decided skateboarding	All of PERSON 's friends love to skateboard . PERSON has never been very good at it . He tried to learn for several months . PERSON made no progress . He decided that skateboarding was n't for him .
girl hated wearing shoes wear sandals time go school insisted wear sandals had sandals feet mom threw sandals sleeping	The little girl hated wearing shoes . She would only wear sandals . When it was time to go to school , she insisted that she wear sandals . Even when it was cold , she had sandals on her feet ! Her mom threw the sandals away while she was sleeping .
noticed tear material couch went store bought needle thread sewed material couch shut days tear reopened brought couch upholsterer	PERSON noticed a tear in the material on her couch . She went to the store and bought a needle and special thread . PERSON sewed the material on her couch shut . Within days , the tear reopened . PERSON brought the couch to a professional upholsterer .
wanted learn play piano start practiced school improved deal play song likes	PERSON wanted to learn to play the piano . He was n't very good to start with . He practiced everyday after school . He improved a great deal . He can now play any song he likes .
woman cut fabric made pattern found pattern fabric cut fabric pattern	The woman cut the fabric . She made it too small for her pattern . She found another pattern . The fabric was big enough for that . She cut the fabric for the new pattern .
bought waffle maker filled batter pressed sides waited had waffle ate found	PERSON bought a waffle maker . He filled it with batter . Then he pressed the sides together and waited . Soon he had a great-looking waffle . PERSON ate it and found it was delicious !
wanted learn bartender enrolled class community college showed hours class knowing expect ends having time learned make lots drinks makes drinks friends has	PERSON wanted to learn how to be a bartender . He enrolled in a class at a community college . He showed up to the four hours class not knowing what to expect . He ends up having a great time and learned how to make lots of drinks . He now makes different drinks for his friends when he has them over .
soup chicken soup 's kind soup eat day tries tomato soup tomato soup becomes soup decides try things	PERSON 's favorite soup is chicken soup . It 's the only kind of soup he will eat . One day PERSON tries tomato soup . Tomato soup becomes PERSON 's new favorite soup . PERSON decides to try new things more often .
years had cabbage patch wheels rode street day day rode way end road man truck hit pulled took home got house yelled aunt watching	When I was three years old , I had a cabbage patch hot wheels . I rode it up and down the street alone every day . One day , I rode it all the way to the end of the road . A man in a truck almost hit me , so he pulled over and took me home . When he got to my house , he yelled at my aunt for not watching me .
walked beach house beach wanted watch sunset way stepped starfish picked starfish threw enjoyed sunset felt had done	PERSON walked from her beach house down to the beach . She wanted to watch the sunset . On the way down she stepped on a starfish . She picked up the starfish and threw it back in . She enjoyed the sunset and felt good about what she had done .
did like drink alcohol circumstances excused events include alcohol evening girlfriend offered glass wine decided drink beverage hoping like wine change mind	PERSON did not like to drink alcohol under any circumstances . He often excused himself from events that would include alcohol . One evening , his girlfriend offered him a small glass of wine . PERSON decided to drink the beverage , hoping he may actually like it . Unfortunately , the wine was not tasty enough to change PERSON 's mind .
wanted liven apartment bought plant watered day watered plant died	PERSON wanted to liven up her apartment . So she bought a new plant . She watered it every day . However she watered it too much . The plant died .
lost dog meant world put posters offered reward stranger called number told found had hit dog car killed	PERSON lost her dog It meant the world to her She put up posters everywhere and offered a reward . Finally a kind stranger called her number and told her he found it . Unfortunately he had hit the dog with his car and killed it .
amber turned television noticed cable working called company told outage amber went store bought antenna installed television amber watch channels issues	Amber turned the television on , and noticed her cable was n't working . She called the company , and was told there was an outage . Amber went to the store and bought a digital antenna . She installed it on her television . Amber was able to watch basic channels without any issues .
wife bought dd artisan doughnuts supposed have filling mine did have filling going complain gave doughnut tasted ok	My wife bought two DD artisan doughnuts . They were supposed to have filling in them . Mine did not have filling . I was going to complain but gave up . The doughnut still tasted ok .
grade school saw girl school bully day decided talk offer sit canteen became friends one expected	I was in grade school when i saw a fat girl in our school . They always bully her because she is fat . One day i decided to talk to her and offer her a sit in our canteen . She is so nice and we became friends . And now she was so slim and sexy that no one expected it before .
loved roller skate did know shared interest decided go rollerskating block time surprise crashed rounded corner apologize became friends incident	PERSON and PERSON loved to roller skate . They did not know each other or that they shared an interest . Both decided to go rollerskating around the block at the same time . To their surprise , they both crashed as they rounded the same corner . Both quick to apologize , became great friends from that incident .
getting show band helping carry equipment stage tripped dropped guitar neck snapped leaving show someone find replacement time	PERSON was getting ready for a big show with his band . He was helping to carry their equipment to the stage . Suddenly he tripped and dropped his guitar . The neck snapped , leaving him without one for the show . Luckily someone was able to find a replacement just in time .
playing board games family losing ran room crying mother went comfort realized having family made winner	PERSON was playing board games with his family . He was mad because he was losing . He ran to his room crying . His mother went to comfort him . PERSON realized that having a good family made him a winner .
getting married sweating husband saw walk aisle nerves gone said do kissed	PERSON was nervous and happy . He was getting married . He was was sweating because he was afraid he would be a bad husband . He saw her walk down the aisle and the nerves were gone . He said I do and kissed her .
went eat night piece meat got stuck teeth have plate did want take public waited got home use floss stick taking piece meat brought relief	We went out to eat the other night . A piece of meat got stuck in my teeth . I have a plate and did not want to take it out in public . I waited until we got home to use a floss stick . Taking the piece of meat out brought such a relief !
laid job picked paper looked help wanted ads sent resumes companies got interview companies got job interviewed	PERSON was laid off of his job . He picked up the paper and looked through the help wanted ads . PERSON sent resumes to several companies . He got an interview with one of the companies . PERSON got the job he interviewed for .
went employer blood drive volunteer gave forms fill turned forms lab tech set donation sat chair donated blood done staff member gave cookie juice	I went to my employer 's annual blood drive . A volunteer gave me some forms to fill out . When I turned in the forms , a lab tech set me up for the donation . I sat in a comfortable chair while I donated blood . When I was all done , a staff member gave me a cookie and juice .
pay attention class wandered mind thinking fantasies nonsense medicated does class does fantasize	PERSON could n't pay attention in class . She often wandered off in her mind Thinking of fantasies and nonsense . Eventually she was medicated . Now she does better in class and does n't fantasize .
had give speech book report speech had incorporate prop book dad helped make cardboard plastic diving helmet speech stuttering got marks speech credit prop	PERSON had to give a speech for his book report . The speech had to incorporate a prop from the book . His dad helped him make a cardboard and plastic diving helmet . PERSON 's speech was full of stuttering . He got middling marks on the speech , but full credit for the prop .
woke work morning rush get left watch nightstand arrived work boss asked knew did have watch told did know	I woke up late for work this morning . In my rush to get ready I left my watch on my nightstand . When I arrived at work I was late . My boss asked me if I knew how late I was . Since I did n't have my watch I told him I did not know .
exhausted soccer practice needed finish homework estimated take hours began work found nose desk	PERSON was exhausted after soccer practice . But he needed to finish his homework . It estimated that it would take him 3 hours . And he began to work . But he found himself with his nose against his desk at 3 AM .
night nurse called doctor doctor said baby distress pitocin drip stopped left lying night doctor coming help	A night nurse called the doctor . The doctor said the baby was in distress . The pitocin drip was stopped . She was left lying there all night long . The doctor was n't coming in to help .
made turn highway floors car fell course jumped barriers grass suffered headache get towing service took car	PERSON made a large turn into the highway . Since the floors were slippery , the car fell of course . It jumped over the barriers and onto the grass . PERSON suffered from a minor headache and was able to get out . The towing service took the car away .
lived door woman had seen woman days walked door visit neighbor found visited everyday recovered	PERSON lived next door to an elderly woman . He had n't seen the woman in a few days . PERSON walked next door to visit the neighbor . He found out she was sick . PERSON visited her everyday while she recovered .
waiting paycheck come vacation state road trip covering ca or excited check came packed bags met friends drove states saw attractions adding joy end trip felt fulfilled work	PERSON was eagerly waiting for her paycheck to come in for her vacation . It was a 3 state road trip covering CA , LOCATION and OR , she was excited . When her check came in she packed her bags and met up with friends . They drove across the states and saw many attractions adding joy . At the end of their trip they all felt fulfilled and ready for work .
soccer player middle game foot slid grass twisted ankle fell pain parents had take doctor	PERSON was a soccer player . She was in the middle of a big game . Suddenly , her foot slid in the grass . She twisted her ankle and immediately fell down in pain . Her parents had to take her to the doctor 's .
waking brushed teeth did basics turned pokemon go made breakfast shocked charizard neighborhood throw food run door go run direction searching hunt begins set hopes finding	Waking up around 6 AM , I brushed my teeth and did all my basics . When I turned on Pokemon Go as I made breakfast I was shocked . Charizard is in my neighborhood , I throw my food aside and run . Out the door I go , and run in one direction searching . The hunt begins , as I set out in hopes of finding him .
had stuffed puppy day mother went post office put puppy mailbox mother looking started screaming mailman got puppy	Two-year old PERSON had a beloved stuffed puppy . One day he and his mother went to the post office . PERSON put his puppy in the mailbox while his mother was n't looking ! PERSON started screaming . PERSON was happy when the nice mailman got the puppy out for him .
family went road trip piled car snacks tow car broke mechanic fixed car sent way smith hit road found energy	The PERSON family went on a road trip . They all piled in the car with snacks in tow . Their car broke down halfway there . The mechanic fixed their car and sent them on their way . The Smith 's hit the road with new found energy .
went wanted ride train closed day repairs decided try pirate ship ended having lot fun conquering fear heights	PERSON went to the fair . She wanted to ride the new train . It was closed that day for repairs . She decided to try the pirate ship instead . She ended up having a lot of fun conquering her fear of heights .
playing bathroom flushed toilet paper toilet toilet got stopped began overflow got trouble stopping toilet	PERSON was playing in the bathroom . He repeatedly flushed toilet paper down the toilet . The toilet got stopped up . It began to overflow . PERSON got in trouble for stopping up the toilet .
town woods year day man came offered buy town people excited had struggling deal concluded man killed town ruined	There was a small town in the woods year ago . On an ordinary day a wealthy man from nearby came . He offered to buy the whole town . The people were excited because they had been struggling . Before the deal was concluded the man was killed and town ruined .
mom gave school clothes went mall excited saw clothes realized afford mall clothes had go shopping department store	PERSON 's mom gave her $ 100 for school clothes . She went to the mall , excited . Then she saw how expensive clothes were there ! PERSON sadly realized she could not afford mall clothes . She had to go shopping at the department store instead .
learning drive time tried crashed thought learn practiced ended passing driving test flying colors	PERSON was learning to drive . However every time he tried , he crashed . He thought he would never learn . He practiced as hard as he could . He ended up passing his driving test with flying colors .
had basketball game tonight team felt team ended winning game relieved	PERSON had a basketball game tonight . He was rather nervous . Thankfully his team felt the same . However the team ended up winning the game . PERSON was relieved .
has lost video game day gets challenged puts fight utilizes skills potential ends winning	PERSON has never lost in a video game before . One day she gets challenged by PERSON . PERSON puts up a good fight . PERSON utilizes her skills to her full potential . PERSON ends up winning 10-9 .
going do laundry find quarters asked roommate admitted used arcade made pay	PERSON was going to do laundry . He could n't find his quarters anywhere . He asked his roommate about them . He admitted he used them all at the arcade . PERSON made him pay him back .
wanted learn sing signed group singing class exercises realized tune teacher coached gave encouragement let go self-consciousness improved	PERSON always wanted to learn how to sing . She signed up for a group singing class . During the vocal exercises , she realized she was very out of tune . The teacher coached her and gave her encouragement . PERSON let go of her self-consciousness and gradually improved .
