the infestation	house had bunch termites started noticing bugs wood work was crumbling called agency come check told had fumigate house
the bug	felt something crawling leg saw bug jumped swatted bug scurried couch stood table someone come smash bug
theater performance	had seen play performed was go girlfriend asked performance thought tickets were be saw play was liked was do planned go
famous	had dream was being everyone loved woke made goal make dream come
PERSON paints her nails	wants try painting nails color looks nail polish decides paints nail 's done nails look is nail color
dirty environment	textbook went missing tried look laundry room dust was flying desk managed find book bin blister broke mouth
fast fight	was chewing gum glass girl sat was asked stop chewing chewed gum hearing ended fighting
pillows	was trying sleep pillow was annoyed sleep decided sleep pillow woke neck ache
wrong pill	had take pill swallowed realized was pill felt hours realized needed be taking pills
bravery at the zoo	thought was went trip field trip friends played prank pretended put lion cage realized was
sick friend	've friend is thought call called yesterday did answer began worry know called know friend is worry
PERSON buys a phone	is living phone decides wants buy goes store choose phone buy buys phone is has phone
opening presents	wanted know husband bought birthday started looking house found hiding place had wrapped newspaper opened took peek
ability	had disorder was do things school was bullied day went counselor told counselor everything happened
brave PERSON	is year boy is told needs tonsils removed is scared surgery becomes brave is surgery surgery goes tonsils are removed
the miracle	day man was death friends carried bed took man called place was get friends cut hole roof let man
seasick	was cruise was see everything became captain gave pills alleviate sickness felt
i , robot	is engineering student tried building robot spent months project working tests were week has lot work do
chess is no fun	chess was game becks liked play were family loved games chess time were chess match families lost front people do play games
PERSON 's new job !	needed job was was cutting hair decided ask salon were hiring salon manager told were hiring qualified candidates got job showing skills
surprise gift	was grade school family gave surprise gift was birthday go shopping mall stuff want was do want buy was 's birthday brought nothing got home saw brought hide
the wrong part	sent girlfriend get replacement part car gave model number description said come hours returns managed get part
sprained ankle	had sprained ankle friends were going wanted go friends mother bought set crutches was join friends
lory the lover	lorry was attention was dumped fiance went night clubs drank pain control lifestyle collapsed home parents friends gave intervention told stop knew were had support needed
bill debacle	will wife had argument bills wife had been charge writing sending checks said wanted responsibility month will charge checks passed forgot write send checks
PERSON 's last rodeo	is rodeo clown has been working job life decides does wan be clown puts show quits rodeo clown job begins
sidelines	kia went son soccer game sat bleachers cheer soccer ball flew stands hit kia cheek causing bruise kia decided sit time
replacement fish	gold fish died parents did want tell bought store replaced was school found truth
italian restaurant	loved food restaurant moved location were found restaurant moved space hoped be
PERSON 's new dog	asked father dog had wanted told have pet trained read training dogs weeks preparing care day went store father was knew dogs had outsmarted salesman
speeding ticket	was running date was driving was pulled cop knew flirting cops get tickets has date backseat cop car
PERSON 's education	graduated school friends went college did want went trade school learned write computer code is leading app developer
ouchless	was getting hair tangled went store buy brush found plastic said was took home used amazed improvement
the science project	school was having science fair entered volcano friend entered volcano won prize vowed work win prize year
dusty room	room was did feel cleaning morning throat felt regret cleaning dust cleaned had throat
skip gets a date	skip was man was looking did know talk women day got courage ask woman date agreed date skip
tree trimming	was trimming palm trees street branch fell ground woman was passing called warn jumped way branch crashed was call
stormy	asked be mama asked was did know mother was clung time was cuddled played lot cried had leave
three men rob barbershop	men robbed barbershop yesterday masked men entered shop held patrons gunpoint emptied cash registers took cash jewelry customers fled vehicle driven man
PERSON needs a spare tire	was driving interstate way work car began make noises stopped pulling found had tire had removed tire make room truck waits tow truck show tire
coffee bean	is citizen likes go get coffee 's food chain gives discount 's been going coffee year today got coffee maker home time does have leave house coffee
from the LOCATION	market town is go watch people met couple yesterday were spoke moment bought sodas bread left stuff bought went way
tree climb	had climbed tree was scared climb tried jump tree landed ankle sprained ankle
the renovated shed .	needed work space home noticed shed corner yard was condition thought clean weeks work returned shed quality appearance enjoyed work space years come
eating snails	parents walked restaurants grabbed table looked menu shock father ordered snails table snails arrived got tasting taste was handle
PERSON 's big win	felt gambling wanted bet money horse is did sat watch horse race kens horse beat made lot money
gloomy	was feeling recognized warning signs depression went see therapist help therapist was kind felt
lemon party	had dream house yard had trees inviting friends had made lemonade everyone loved friends snuck bit went looking did friends had snuck trees begun stealing lemons
ball over the fence	were tossing ball yard tossed ball fence ball went neighbor yard climbed fence get ball was ball
PERSON finds a watch	evening walking home work notices something laying ground heads look is picks notices 's watch takes home keeps
PERSON has no luck	is looking date tuesday night decided look internet browsed profiles messaged girls none replied had luck finding date
the egg hunt	family had easter gathering hid eggs kids had surprises kids searched hours was fun everyone involved
PERSON 's new puppy	was kid house did have pet sleep started feeling mom got puppy was puppy sleeps cuddled puppy
neverending	decided watch neverending story searched discs find went netflix was tried luck gave went bed
cashier	had go make groceries made budget made list groceries needed went store got everything list got home reviewed grocery bill got surprise discovered cashier overcharged went got money
the christmas parade	was time holidazzle christmas parade downtown took kids downtown see parade waved people floats children cheered float drove kids thanked mother told had time
PERSON burns the house	is playing matches drops lit starts burn cabinets tries put put fire burns house
bad neighbors	have neighbor is ways july neighbor shot fireworks midnight display went nights dog asked neighbor stop noise days man cussed husband challenging fist fight
grateful lady	was work bath body works customer wanted purchase product lady was upset were checked storeroom found box customer was help
the pool fight .	was swimming pool was splashed girl confronted girl girl friends got fight started ended leaving pool
garage party	friends were dancing garage were having time brought chips dip share kids went home brought snacks danced partied was time go
shadow puppets	play shadow puppets was suppose sleep stay making kinds shapes mom hated was morning school night saw set hands making shapes fear hid covers fell mom tricked
building a sand castle	was beach wanted build sand castle created setup tide started coming took pictures was destroyed
acting lessons	decided take acting lessons went class teacher did show was bunch students waiting turns teacher was pretending be students were impressed acting lesson learned
the dentist lie .	friends were planning skipping school wanted join was get class decided pretend had dentist appointment note school believed was leave problems
the dream	wanted play football grew was father began teach game school days think anything was school was players college was star became
the dolphins	family was boat were going dolphin cruise took saw dolphins chased jumped water took lots pictures animals
the season of giving	had bought coffee coffee shop walked shop noticed man was huddled shop looking offered coffee accepted was have done something honoring holiday spirit
unfair	brother had power wheel truck wanted was brother loved played truck day began despise brother truck decided was brother have truck
helping out	lived beach year was event put town grandmother went help spent day cleaning beach trash debris grandmother got picture paper
wood wins	kids are competing see break block goes takes seconds think punches wood finger broke doctor wrapped bandage
thirsty PERSON	was went kitchen get glass water got found did have glasses looked coffee mug drink were none drank water bowl
granny 's spaghetti	grandmother makes spaghetti eat love day brought dog visit realized feed dog table bring dog visit grandma
PERSON 's club	wanted start club school found teacher sponsor made fliers advertise club meeting were loads people were have club
PERSON PERSON falls in love	grew mile tucker cherry farm met boy named skip became friends playing school skip fell love became soulmates
a stuffy office	needed air office basement sunlight decided take walks hours things started feel ended feeling taking walks
the haunted house	was visiting aunt house was rumored be haunted was walked living room found ice cold saw fluttering corner eye turned face flutter laughed relief window was cracked letting draft blowing drapes
the reel	went movie theater looking job manager said be projectionist ticket taker took job projectionist went projection booth start work movie ended people cheered work
constant interruptions	was trying tell story friends friend kept interrupting tried play nothing got told friend stop friend apologized did
PERSON 's washing machine	realized something was washing machine saw laundry had finished draining decided check owner manual saw said be load was did have call repairman
trying the water	brothers spent time woods brother made homemade filter tried getting drink water refused was was siblings tried liked
PERSON visits a rhino	had wanted see rhinoceros saved money trip city zoo zoo saw rhinoceros was had imagined be was got see rhinoceros
lamp purchase	likes read novels apartment has lights are reading decided go furniture store get light ended spending lot money reading lamp treasures reading lamp give pleasure
churning ice-cream	week aunt got idea decided make ice cream scratch churned ingredients created recipe was everyone family loved
lonely picnic	was picnic expecting friend arrive waited hours nobody showed ended eating food brought got car saw friend arrive left
one handed jar opener	lost use hand had trouble opening jars bottles used feet success found device sits counter lets jars device has proven be
the dresser	found dresser brought home wanted restore scrubbed put stain looked decided wanted restore pieces house
cereal prize	was collecting toys cereal boxes had toys need collection get one bought boxes cereal opened boxes dumping grab toy toys had fell boxes
the deer	sat tree stand was looking deer saw cross field fired shot fell loved deer hunting year
treadmill	loves swim used do day gym is has time getting pool asked doctor do exercise stay doctor recommended walking treadmill gym gave try loves treadmill
25th wedding anniversary	wedding anniversary took wife honeymoon went train stayed side is did got married had time
chocolate	was eating chocolates ate deal husband came home work remembered day was ate chocolates bought valentine
solemn wedding	dreamed wedding had planned queen be regal married had money bought candy bars guests had do
utilities	utilities bill was afford decided stop using electricity bought candles bill was
prank fail	bed heard someone whispering felt chill run spine turned lamp bed walked closet opened find brother trying scare
a new fish	day was watching fish swim tank decided be grabbing purse ran car drove petstore petstore had fish chose lady store helped find fish
the wrong date	prom was supposed be everything was going were having time danced friends night song came find date dance floor went cool 's saw date making
PERSON plays baseball	was going learn play baseball today got baseball gear put baseball uniform fitted mitt was dressed was go play baseball mom drove baseball practice
bossypants	felt have been liked be charge decided ask parents sibling parents decided have babysit baby cousin was be
studying for the test	had forgotten study math exam teacher was had sub test was postponed was relieved studied night test
secrets in a letter .	has been working science 's developed equations relating mass energy knows lead weapon feels develop weapon describes ideas letter president
computer problem	bought computer did want turn tried everything fix problem took store was found be replaced
new ball	ball got stuck roof boy told dad dad got ladder ladder was dad got son ball store
carpet scratched	cat is devoted wife follows today wife closed door get dressed cat scratched carpet trying get wife said cat is obsessed
problem solved	enjoyed going runs went run block wore shoes shoes gave blister took week be run owns running shoes wear
PERSON 's late	is delivering pizza road runs something gets see hit had hit piece glass was delivering pizza car trouble
ice block battle	worked ice warehouse wanted see sit ice sat felt felt time won contest gave
tlr	camera was lens bought was copy rolleiflex had look camera view subject use camera
broccoli	loves broccoli decided make broccoli cheese grabbed cheese cheese melt dish turned
the disgusting fridge .	had bought fridge online had delivered owner noticed thing was opened found mess took hours clean thing
patience	yesterday was birthday was monday had go school knew had birthday party school was excited day got party was
sizzle	liked bacon breakfast came breakfast was shocked box cheerios was counter asked mom did make breakfast told was year do
bulk up	is trying bulk muscle is lifting gym is seeing results body read online needs eat calories was did noticed results week
little league , big dreams	was disappointed did make baseball team brother noticed was offered help was star athlete had lot tips was player time tried was chosen team gave brother hug
PERSON 's fence	adopted labrador puppy named loved run day was injured was hit car had fence installed was hospital loved playing yard
not really a gift	mr poke donated millions dollars radio radio station aired news business practices mr poke demanded station stop airing stories station said was duty inform public mr poke withdrew support radio
bad credit	was hoping get approved auto loan sat banker waiting hear be qualify dismay was informed credit was went home got work fixing credit took year improved credit
you are not alone	was sitting country money was preparing call mom was did want talk dialed cat emerged brush sat lap conversation mother
basketball rim	was playing basketball friends jumped dunk ball ended breaking rim came crashing jumped way looked hands awe strength
sunflower seeds	took bag sunflower seeds asking made father allowed do began spilling sunflower seeds spilled sunflower seeds father said be sunflower seeds are banned house
finally done	grandpa was finishing lunch jumped go friends ran car waited grandpa minutes went see was taking walked find searching find keys
tasty necklace	students strung colored cereal pieces necklaces let students wear art rest day dismissing class wanted photograph necklaces asked students line picture having eaten cereal necklaces were reduced strings
retire	was baseball player had been game years noticed body giving wondered keep times decided retire
guess	kia had lost measuring cup was making casserole needed was forced eyeball ingredients had done feared food be casserole came
death from diving	man named was scared heights friends wanted overcome bought skydiving ticket knowledge had go jumped screamed life survived
the dirt mess	was house making dinner son had come playing watched took sweater dirt spilled sweater floor had stop was doing
long security wait	yesterday airport had wait security was line hour was was carrying items line dwindled was relieved vowed go
the copy	was finishing novel nephew was boy took book ripped shreds was phased had made copy took copy slapped head
tightrope	balanced tightrope concentration heard girl cheering name turned saw girl lost balance tumbled ground caught saw girl laugh leave tent
the hockey game	loved seeing sports played was going hockey game did know anything sport was excited took friends sat cheered home team
raw oatmeal cookies	was making oatmeal cookies put oven set timer minutes timer went opened oven door cookies were had forgotten turn oven
no nuts	was nuts kind attended grandma party had piece cake hours got was rushed hospital was having reaction nuts lady cake used nuts frosting
risky riding	liked riding motorcycle friends warned be scoffed night skidded hit truck was shaken be was urging needed be
blanket head	've been girl child used want hair put blanket head ran felt woman 've worn hair
new tattoo	wanted tattoo was get decided get star sat flinched started wondering made decision
creepy church	was parents made go church thought was preacher said was decided stop going
new	wanted get bicycle fixed bike technician fixed told buy decided picked bike rode trashed
PERSON plays video games	finds has lot time work decides needs take hobby decides start playing video games finds fun is have something do work
lights on	friends were trying sneak house left house was kitchen light was asked do stood doe eyed confused
the girls	had daughters loved spending time girls took shopping day bought lot clothes laughed lot loved making memories girls
purroblem solving	suffered anxiety therapist recommended get cat looked shelters visited adopted cat is
PERSON and the toilet	had go bathroom was done flushed toilet toilet did overflowed had get plunger unclog toilet unclogged had spend day cleaning water
horror scope	woman dress offered mailman soda declined horoscope had said be water today mailman knew soda was water knew horoscopes were
broken computer	computer was running was opened screwdriver saw was clogged dust blew dust compressed air
lying PERSON	were married years told was going get gorilla tattoo touched was going meet mistress noticed tattoo looked accused cheating lied
vision	started losing eyesight years figure read blackboard teacher scolded taking notes told words were called parents had get glasses
the getaway	is year took date dinner date flirted year waitress time excused saying had use restroom came waitress got tip
girl shirt	bought shirt goodwill liked way fit wore friends night friends told was girl shirt realized did care
first pregnancy	remember pregnancy was had morning sickness time co-workers were experiencing run comfort room have vomit gave birth 's
the old ipod .	was cleaning room was cleaning couch discovered ipod had been missing years turned found photos friends made smile
building a snowman	kids wanted build snowman rolled balls body had help stack balls top borrowed hat dad closet gave carrot nose finishing touch
amber gets her car fixed	amber drove home work night road was flooded drove tow truck had come tow car had go shop get repaired cost boyfriend lot money get fixed
feeling queasy	had eaten dinner was stop eating was done felt had take ginger tea drank felt
bread oven	wanted make bread was yeast grabbed ingredients found needed egg asked neighbor egg yeast neighbor was baker had supplies enjoyed home made bread night
PERSON and a bully	was being bullied school told teacher mother bully got trouble got detention day detention apologized sue being mean became friends stopped bullying
grandma 's yarn	was person wanted learn knit did have family show did have neighbor called grandma asked grandma teach knit lady taught basics knitting crochet
the needles	was knitting had set needles wanted test knit blanket hour decided needles were wait see knit
the sneeze	was dinner co-workers felt urge sneeze tried muffle bit were dinner made pass gas everyone was
lucky guest	decided have hamptons house did have wanted take care thought was got house was felt
coffee here coffee there	'm coffee drinker have been 've tried coffee including countries make home go get reason gas station house has coffee 's place choice 'm getting coffee
put them away	had gotten pencil had taken people minutes chasing decided put pencils take put desk left day was pencils be classroom
backsliding	had broken girlfriend had been months hour had year phone were week broke day time happened
winning the lottery	bought lottery ticket thought won prize roommate told was prank ticket was was heart broken
keyboard	eats desk boss tells day spilled spaghetti got sauce keyboard keyboard had be replaced
stinky shoes	walked home smelled odor looked find source decided clean house get smell was done realized odor was shoes threw shoes dumpster wore pair
pasta night	did eating pasta family went eat grandmother house mother had cooked spaghetti lied said was made sandwich got home
freeway speed	bought sports car wanted see go sped freeway am reached mph was go
driving experience	driving instructor arrived left house drove house turnpike driving school recommended taking driving test today taking advice consideration signed performed turns passed test
one more	had work assignment do did want do decided bear get done was work employer thought was
ham	was walking street saw man man begged money did give money felt did help day bought ham brought man felt man
the auction	had been going auctions months was looking furniture day spotted buffet bidding kept going was going cave spent fortune piece
two neighbors	neighbors hated decided build wall had see had brick wall erected property hated wall weeks was built vandalized wall paint
neighbor	had neighbor was widow heard neighbors health began failing hired nurse come day neighbor home visited widow passed spoke memorial service
95 year 's old	was year went doctor told drink coffee eat sweets matilda went home poured cup coffee grandson scolded listening doctor was year didn
the tooth crack	was playing basketball friends someone threw ball right face surprise tooth cracked was look dentist was fix
strategy	man came strategy moved markers board explained moves soldiers soldiers asked questions man answered
buying a house	weekend fiance visited are considering moving year went check houses met realtors enjoyed city decided move time year
tv show	watched episodes cartoon did thought friend like told encouraged watch is obsessed cartoon joke dislike allowed find
PERSON learns calculus	finished college years learned calculus decided learn topic borrowed textbook library studied worked learn topics was knew calculus
PERSON wins the award	is tv actor is nominated award arrives award show wins award show goes home award
hot sauce	loved kinds food owned collection sauces ordered food menu day ordered wings restaurant mouth was fire days met match
PERSON interview	had job interview position was had idea work went shaking walked got job
discomfort	brother had been house was fought father dad was foot pounds felt
friends at the amusement park	went amusement park boys had lot fun water rides was go roller coasters rode roller coasters waited ground teased riding rides
professor PERSON	professor was liked teacher history church sunday student stood talk professor did remember student was worried student was offended professor invited church professor asked forgiveness had stroke
christmas decorations	put lot christmas decorations neighbors liked took christmas neighbors started complain decided take
bipolar	friend daughter t came visit week lives tn used live rented car t get day was car t cut people argued t found was taking meds
PERSON 's talent	wanted be singer practiced was singer decided try painting was was had discovered talent was gave painting try
tailor PERSON	worked tailor shop summer duties included altering dresses received wedding dress alter was worked day night dress make client loved invited wedding
dance it off	was excited day was was wedding day was worried was realized moment had ordered cake called one fulfill request decided wedding pie have suffice
retired	man retired had nothing do watched television health became died heart attack
my daughter	daughter is years has friend friend fight apologize fight is are
the hand at the window	was day work sat chair tv was engaged show heard noise looked saw hand resting window glass got grabbed gun walked got window saw hand print person
the purple room	was boyfriend color was decided was color painted bedroom wall was violet loved broke was rebelled repainting room neon color
virus !	had problem computer took computer repair shop day shop called will told computer was loaded viruses had buy computer
dog fight .	walking home store noticed dogs did do started attacking tried breaking fight neighbors pulled dogs
no fish	was fishing uncles was seemed be fish began complaining pole got nibble tried reel caught nothing end did catch anything
candy sick	got lot candy halloween had bags day ate candy got night did stuff
blue stain	day was doing laundry got clothes put basket shirt had stain soaked scrubbed wash stain was gone
they meet	saw go bathroom friend followed froze saw was going pummel brat friend june came saved fight
broken string	went boston symphony orchestra concert guest soloist was violinist performance violin string broke everyone waited brought violin crowd applauded end performance
working hard	graduated college lot debt money owed was making worry was rejected job interviews interviewing walmart bought gun sports section was killed trying rob customer service manager
PERSON replaces his stereo	realizes stereo system home is getting decides look replacement buys stereo system sale store sets home sounds feels has stereo system home
flower picking	yesterday went flower picking have garden yard went picking picked tulips roses was done put vase got compliments flowers
housing crisis	decided buy house market was doing meant was buy house decided invest money housing market housing market collapsed
inti	do volunteer work profit group called inti group runs soccer art school kids today director sent grant proposal proofread made edits returned proposal hope get grant
new group member	manager introduced employee was guys were excited did lot favors treated person being approached
the bird	was playing bird decided perch shoulder was excited took picture bird bird flew realized bird defecated shoulder
bb gun	kia classmate pulled gun science class day everyone screamed cowered desks police were notified came found was bb gun took student evaluation
a man and his horse	came corral horses man road needed sell purchased name muffin muffin came live farm muffin taught bill cherish friends
sand in shoes	returned beach sand shoes stopped porch took shoes dumped sand put hour mother called living room got trouble sand had been tracked house
leaving social media behind	had created hit movies signed twitter account had dozens mean messages tweet said was going die said movies suck closed twitter account stopped using media panel films fan begged come twitter
PERSON adopts a son	feels have children has met woman wants have kids friend recommends try adopting son adopts son becomes father is became father
evicted	lived years fought lot disrupted neighbors neighbors grew fights filed complaints landlord get complaint day months landlord got tired evicted
two PERSONs .	was summer camp kids were playing get know game was partnered someone activity boy introduced bonded name
first dance	remember dance was prom night school dance is friend do know 'm asked dance night 'm friend is ask gave rose
PERSON 's store	wanted buy bread store went store bread was gone wanted be bread decided open bakery has bread dream
keeping your cool	got home was looking homework searched room found baby brother was ripping homework pages eating was did attack brother threw remains did homework
always late for work	boss was yelled being work explained was caught traffic told was be fired decided leave get work time
beeping	dreamed was beeping looked dream find source woke realized was coming microwave
anaphylactic shock	had food allergies eating asked ingredients dish yesterday restaurant was served nuts ate nuts realizing were went shock result ingesting nuts
sneaky snake	was person hated people class stole books classmate threw garbage had friends
joker 's wild	loved playing card game called joker wild decided set joker wild tournament friends friend did want participate tournament friends felt cheated win joker wild was disappointed play friends
the sleepover prank .	sister was having sleepover friends decided prank waited were watching movie jumped scared realized was were
bugs in the bed	was bed sleeping felt tickle arm turned light was bug bed called exterminator day
folk music	am fan protest songwriting is decided research life learned died suffered illness find person
low clearance	was driving truck highway was was paying attention signs failed see sign warned overpass truck was clear overpass got fired wrecked truck
PERSON in LOCATION	had wanted live being seemed university applied visa go work got job barmaid was known friends
sunny day	was day couple is touring city anniversary 've seen sites taken lots photos day is are going pizza year couple returns experience
jello	was diet craving sweets boiled pot gelatin added poured molds let set fridge jello dessert was snacked dessert
PERSON is afraid of storms	had dog named hated storms news issued storm warning evening knew had comfort storm was comforted
itchy skin	was swimming was home felt tried scratch felt found made
PERSON washes dishes	has hosted party feels realizes needs wash dishes begins cleaning plates continues cleaning glasses is finished cleaning dishes sleeps day
stone	stone was boy loved play football day was playing football playground got hurt boy threw football hit face stone glasses got broken got bruise day stone was playing football
learning to walk	has lost ability walk breaking legs work doctor told was time start walking tried day day get feet walk weeks manage walk door is walking is work
home late .	was friends needed be home hanging lost track time got home was midnight mom grounded being
starwars	matt loved star wars was excited see movie went buy tickets were sold was being buy tickets found tickets ground was
dvr	show was liked record watch way did have watch commercials forgot record show was had wait was online watch
grandpa passed away	went breakfast speech was blurred worker was alarmed called ambulance went hospital had stroke passed week
PERSON 's big day	has been years wants job has had trouble finding gets interview newspaper works prepare newspaper interview preparation pays is offered job
ring	wedding ring fell faucet ring fell reach used be plumber took pipes faucet ring was was be retrieve
musical inspiration	attended piano recital parents music inspired learn play piano started taking lessons years held piano recital crowd applauded felt
lazy	was habits stopped brushing teeth people work complain got someone offered breath mints took hint brushed teeth
fleet of ships	fleet ships advanced island submarine snuck submarine fired torpedo ships ship exploded ships fleet scattered
adult	man made joke woman called man wanted look started speaking voice made woman respect
setup	band set show drummer find bass drum asked guitarist help went van look base drum was sitting van
go for the gold .	had trained swim competition weeks came got vomited was turn swim had happened family were concerned ended swimming race setting record
bad boat	family bought boat kept running gas made was time did know was happened boat seem gas sitting fit realized was air bubble line was did have problems
laundromat	had guinea pigs cage had fleece bedding did want wash bedding house fur went laundromat felt closed day fur dryer vents
two suits	needed get suit wedding was deal suits bought decided wear store drove home realized left clothes store called store agreed pick
the rock climbing accident	son went rock climbing weekend fell ground ankle was twisted wife rushed hospital had have surgery
PERSON 's new house	bought house moved house week was water leak house called plumber plumber fixed leak
cake	was depressed grandparents were trying cheer attempts made tried be wanted be left asked grandparents leave locked door
watering the garden	ivy needed water plants turned sprinkler ivy filled watering poured water flowerpot ivy turned sprinkler
new hook	put self hook wall desk home put scratcher shoehorn put jacket hook came tumbling am buying nail hook tomorrow
the memorial	family went downtown looked war memorial read names carved stone felt walked home
waiting up	was friends mom did set curfew called check told was waiting felt situation decided go home time
free throw	played basketball school team missed throws coach recommended practice practiced throws hours scoring game was practiced
gain	worked lose pounds was began gain stopped gaining worked lose regained weight
polio	sister law brother had polio was born was baby mother noticed legs were kicking took hospital was diagnosed polio family moved house had
feeding the birds	loves filling bird feeders home enjoys seeing variety birds attract birds glare window are fed fills feeders birds alert friends chirping food is supplied loves seeing
the big white dog	wanted have dog decided go pound rescue dog got pound saw dog dog looked eyes knew was took dog home was
pet ferret	day got pet ferret named whiskers whiskers bonded cuddled lot was got
long line at the store	yesterday went clothing store got was waiting hour believe line was was done shopping was waiting hours knew go
a heavy weight	has beaten empire president had make decision invade use weapon consulted advisers decided use bomb
bailing his brother out	had brother looked brother kept getting fights school tried keep fighting day got head was helped brother resolve conflict fighting
no car for class .	was photography class teacher let students go campus take pictures did have car did know anyone class car had take pictures campus
fantasy	was library decided look books found absorbed fantasy novel reading was did weeks loved reading libraries
my new sister	was parents got month birthday sister was born was child point being had changed was did seem had sibling
PERSON records another hit	was struggling musician had hit people wrote hit wonder wrote song prove everyone song went be hit proved everyone
martial arts class	asked father sign mma classes father agreed took day day class junior learned was stop asking questions loved practiced hours got home
hiding information	had gotten speeding ticket was scared tell parents information was published paper parents found citation got trouble telling parents
laundry mishap	needed do load laundry added clothes soap washer minutes heard banging saw bubbles realized had put dish soap laundry soap felt making mistake
lipstick allergy	bought lipstick online was manufacturer tried wearing date lips started swell had take lipstick
the missing bike	rode bike school went leave bike was gone walked home school told parents bike was missing parents called school bike
cupboard	man looked cupboard were plates man did dishes put dishes forgot had been looking
basketball	thought played game basketball decided challenge friend agreed play practiced days game ended beating points
travel adventure	wanted go vacation was go researched vacation spots library talked travel agent trips decided buy tickets
cut foot	broke glass floor did clean glass mom stepped glass foot was cut had get stitches hospital
the ladder	was fixing bulb took time reach gave ladder changed bulb was
storm arrives	storm clouds were approaching work building ran car get umbrella was get umbrella ran building storm came shut door used umbrella rain left work hour
talk	man talked friend friend expressed frustration man sought help friend friend remained man decided friends temperament was
too sour candy	loved candy thought handle day decided buy took home tried was threw
let it rip	was walking barbed wire fence got pants caught ripped hole was friends saw thought was cool decided did mind ripped pants
the coffee shop	wanted start business decided coffee shop be business researched planned got work was open coffee shop got news city had denied permits
PERSON gets glasses	notices is see objects thinks need glasses gets pair glasses see is see objects
broken fan	had fan needed be replaced day started spinning control one blades flew hit was forced replace
bakery	owned bakery spent life savings open bakery nobody liked pastries sold bakery was failing decided burn bakery see fail
skin	wanted sun tan look put bikini went beach laid sun putting sunscreen fell sun woke hours looking looked lobster
the pergola	was working yard built pergola tub wait vines grow was going be oasis had plans future yard
anger problems	was mood work yelled people bus stop screamed bird realized was eating pizza felt
outside toys	daugher left toys spread yard warned weather was coming did listen warning storm hit blew toys neighborhood is crying roaming neighborhood
fake illness	was coming addiction felt started affecting job told boss had believed kept job
stuck on the lake	friend took rowboat lake halfway dropped oars were stuck way get touch anyone hour boat came girls got rowed boat shore
out the door	was time take kids school were bundles coats hats remembers forgot lunch rush kitchen throw lunch door go school bond
the uncooked turkey .	was thanksgiving day was charge turkey food was table was set checked turkey saw bottom was cut pieces served
belated birthday	was throwing birthday party friend sent invitations cake one arrived party have started realized wrote time invitations everyone arrived hour
the store in the morning	needed go store husband worked had go everything was was was everything was made home
PERSON the vixen	was women growing had looks was school did care did need was coasting looks wanting become model started doing music videos became video vixen time became made school knew
broken cookie	was eating milk cookies was dipping cookies milk soaked broke half half fell bottom milk glass had use fork get
ruined food	waiter served food family gave place aunt offered salt said poured lot salt food tried eat tasted waiter had throw
the fat man	was man ate did care was day fatness clogged arteries man had heart attack died tried bury was coffin
pressure	bought pressure cooker decided make rice filled cooker rice water left room panicked lid exploded cooker rice had swelled caused explosion
singer	wanted learn sing auditioned sing church choir director said voice was tenor learned read sheet music am singer was joined choir
relaxing at the beach	loved go beach decided spend afternoon beach dug toes sand watched ocean waves spent afternoon relaxing beach
snack time	sat class classmates staring clock was snack time waited waited bell rang sprang front room was was line food
lost contact	was changing contact lenses dropped floor looked took time find time got contact lens was
seeking a thrill	went spend day fun sun tried rides wanted try roller coaster was line waited hour time came sat anticipation ride lasted seconds end was exhilarated
cleaning the house	had list chores complete day started sweeping floors mopped kitchen bathrooms wiped surfaces find finished laid couch took nap
PERSON 's allergies	had allergies was cleaning house dusted fans baseboards were began sneeze had eyes
ice cream day	opened door ice cream parlor knew product wanted saw flavor sparkled case was drawn floating display case requested taste test buying ice cream flavor
bartering boys	parents told clean basement was going be job felt asked friends help hesitated promised play xbox exchange everyone helped were playing video games
learning to dance	wanted learn dance college called friend mine teach was dancer was taught everything knew dancing made am dancer
the fleeing dog	took dog walk dog got boy chased dog caught dog leash boy returned dog
two monitors	had lot work do computer had windows had screen space left bought computer monitor monitor allowed be
rock climbing fun	dad decided go meet rock wall put harnesses started climbing had ton fun raced dad top ended winning
giving birth	knew baby was be born felt water break told husband angel angel rushed hospital went labor hours hours baby boy was born
PERSON 's visit	was feeling wanted see family was visit was terms family decided father lived visited father felt
cancelled	husband mother asked talk sat porch beer hand began telling childhood was abused father was numbed warned turn
spectacles	kia had wear glasses day school had forgotten order contacts was was knowing be mocked kids surprise kids did seem care kia was relieved had worried nothing
destiny	had friend wanted set date friend said guy be was day met man coffee shop went date discovered was guy got married summer
toddler play time	is years toddlers loves play today played rain danced puddles got took shoes went
accuse	sat class got went bathroom came sat noticed pen was missing did want accuse pulled
tour of LOCATION	finished reading murder mystery featured lot stores landmarks loved lived years read book toured area see locations got excited news make movie
cleaning the case	needed clean computer case build took rag sink cleaned crevice case dried case hairdryer case was be used
champion archer	was archer ended entering field archery tournament needed bulls eye win tournament managed hit bulls eye won tournament was awarded gold medal
starting the car	was working car was having trouble getting car start brother was mechanic got brother come brother got car start
bologna	got bologna sandwiches lunch day complained wife was bologna showed images children world put things perspective realized was get bologna day
the speaker	was noise room speaker was blasting rock music tried figure turn get everyone covered ears left room
rude customers	was working cashier grocery store customers were made fun making money day decided had quit job go school
the yoyo	had toy was yoyo wanted learn do lots trips watched youtube videos hour learned do things
the random vacation	friends were drinking bar dd says lets go end driving hung beach hours drove
driving with his brother	was learning drive brother car brother was driving brother thought was talking stop light brother got took driving had learn drive someone
grand marnier drink	coworker used drink grand marnier pineapple juice wife was looking drink try tonight had grand marnier pineapple juice did find pineapple juice said drink was fun
nachos	sue entered nacho eating contest nachos are food thought do sue started pace upped ante sue ate pounds nachos did win
choices	wife had decided visit january christmas took surprise give gifts take vacation decided give gifts is year
dead motor	husband own boat take boat fishing night was sunset decided come motor died had paddle mile shore arrived hours
the purse	wanted buy wife something got print purse opened was did like idea ostrich being harmed said return
wonder woman costume	wanted be wonderwoman halloween went costume shops looking costume shops were sold decided make woman costume costume was
red sox tickets	wife is retiring weeks coworkers found gave wife tickets sox game is going son was
hot food	decided heat food microwave tossed placed timer minutes minute container splashed place felt burning sensations pain went
bloody nose	was work day got nose ran back store grabbed towel cleaning made nose was bleeding looked saw line people waiting ran got work
plot twist	woke prepare day school got campus girl greeted introduced commented looks had conversation exchanged numbers addition asked day
broken promise	grade friend made deal agreed have girlfriends hang do guy stuff weeks found had broken agreement found holding hands recess
dark stranger	fell love stranger town strangers invited man move day left man note pick work did arrive was did know stranger read
PERSON loves to bake	enjoys baking friends basis decided enter competition fruit judges competition loved fruit won place competition
i 've seen that episode !	woman went twentieth school reunion was job having seen lot sitcoms decided being doctor did everyone was reunion
the wedding announcement	was enjoying wedding reception cousins stood began speaking cousin announced was earning cheers was annoyed cousin stealing attention did want seem did say anything
track star	was walking school hallway noticed poster read poster advertised track club meeting image throwing shot put flashed mind decided moment try team had been working thought was was
end of shift	yesterday end work shift was cleaning store cleaning noticed woman sitting bench front watched lay bench vomited continued lay bench locked store left
co-worker	hated co-worker got were scheduled work co-worker crossed line got fight got fired
the tennis player	was tennis player won awards playing tennis clubs school was graduate college offered tennis scholarship adam accepted scholarship attended college
calls	kept getting calls seemed be pranking got tired blocked number did get calls looked online found 's guy does lot people
hopscotch fun	was playing hopscotch sidewalk saw wanted join played til sundown had fun
the sandwich	were eating sandwiches left room was gone licked sandwich got realized did was pay back smeared peanut butter sandwich vowed lick sandwich
the roses	saw van pull house man got handed roses were boyfriend was called say thank
PERSON 's beach party .	wanted throw beach party friends sat table wrote needed party went stores bought items needed called invited friends wanted party threw beach party had time friends
picking weeds	yard was becoming was overrun weeds put gloves went picked weeds hours picked weeds yard looked
elephants	loves elephants has wanted see elephant life honeymoon convinces wife go wife travel go tim is see elephant
vegan diet	wanted change diet decided be vegan cut was was was changing lifestyle
cough drops	came lamented illness stayed home bed developed cough did have medicine called friend asked help friend brought bag lozenges hit spot
fear	was doctor appointments had phobia having blood drawn did like shots doctor intimidated does like going doctor
hot water	roommate used take showers leave water use had write note leave counter note asked take showers note takes showers
grey	cloud was man decided bring coat began rain man put coat coat protected rain
the bad rental	was city work needed rent car get options were limited picked rental was hated time
the wet phone	wanted take bath bath was playing games phone dropped phone bathtub panicked put phone rice rice dried phone was use
fishing trip	went fishing trip caught dozen bass caught nothing knew wanted bring fish home family gave fish caught frank was have trip invited have dinner family
the dog park	took dog dog park was having fun dog started trying attack had intervene took dog home
PERSON 's night out	wanted go birthday went friends club dance night dancing went friends eat had time
morning coffee	was mornings drinking coffee lots caffeine helped relax had cups today had coworkers pitched bought
ashram	was years wanted find traveled studied ashram studied thought lot wanted be end months flew went college did
the scissors	is grade sits front class day uses safety scissors cut lock hair school treats incident assault weapon school suspends days
tags	wanted keep dog found knew needed go home owner found dog had tags felt dog knew had find home
ask mac	mac started writing editorial school paper was called ask mac students wrote ask things offered advice mac loved writing ask mac
acne	had acne was self esteem hated looked mom took dermatologist skin cleared time
the jury	was trial jury watched move knew thought was tried look jury found
impulse purchase	was wife sent get groceries went store got sidetracked wound buying things did need wife was upset
PERSON the bragging runner	was bragging was track runner bragging became friends track team track girls challenged race ended beating race second bragged running
PERSON finds gold	is playing front yard trips something looks see is digs finds chest gold
watching fireflies	son got excited saw fireflies movie did believe are insects light explained are country decided take drive find eyes grew one spotted
overflow	was oatmeal decided leave kitchen while came minutes overflowed stove left kitchen time cooked oatmeal
the wrong flavor .	was grocery store husband asked pick juice bought juice groceries got home checked juice had gotten flavor
a moldy mistake	eve year spilled juice carpet afraid getting trouble covered bean bag chair eve forgot did mom was vacuuming moved chair was horrified find mold juice was spilled
new guitar	wanted take guitar lessons was thought be gift parents got guitar was
hungover	had sampled mom wine night mom had caught grounded morning woke hangover thought was punishment grounding vowed drink alcohol
training the new girl	part job was train people restaurant today had train be hostess was phones was greeting guests decided was cut job fired was vowed find job is
pothole	house was pothole knew hole avoided people did know hit hole called city pothole crews came fixed pothole day
business trip	went business trip got apartment was wife was be found was note refrigerator wife had left filed divorce
PERSON make a song	is kid loves music starts write words song records song studio made song
new couch	needed move couch home home is flights stairs ground enlisted help friends grunting shoving got house did match room decided be content
the PERSON family takes a vacation	family has gone vacation years decide go swim surf have time family is took vacation
a dodgeball to the face .	was playing dodgeball pe had been taunting girl team was looking threw ball nailed face apologized help laugh bit
shrunken shirt	got t shirt day wore wanted washed decided put washer was washed tried dismay shirt had
science	was doing science experiment was experimenting frog was giving drugs see react frog died was expected
fake PERSON	asked barbie doll birthday got imitation pals invited play dolls teased doll walked home tossed doll bushes
veteran 's day	wanted do something veteran day went shelter were veterans helped feed felt end day
dental work	went root canal dentist said help first had remove tongue rings had had years were remove
PERSON picks apples	decides wants try picking apples orchard brings basket collect apples drives orchard orchard picks apples takes apples home eat time is went apple picking
more mistakes ?	made mistakes asked help fixing people refused help stopped caring mistakes helped make mistakes
meatloaf	sunday sister-in-law dropped visits talked time left meatloaf gift had meal night
PERSON 's revenge	was marriage cheated wanted revenge put sugar tank slashed tires divorced day
a girl and her fern	begged mom puppy mom gave fern mom said took care fern get dog forgot water fern week has practice responsibility cactus notice
the very big reunion	was bit going school reunion feared group girls made fun be put brave face neared reception hall was relieved discover girls had gotten fat being fat made girls had time
being too hasty	family came aunt house played hide go seek was turn look everyone looked shower curtain pulled curtains ended pulling sister hair was
not a phone	wanted phone christmas anything unwrapped was iphone box opened find silver bracelet mother had been trying trick was box had was christmas
first snow	snowflake drifted sky ground saw happen window went collect flake was be found waited flake arrive
director	was actor play rehearsal forgot lines looked stage director worry director gave look felt had studied lines
milestone	friend asked hang became puts work inconvenience see did hesitate say 've said past understood left end remained friends
winter storm	did snow did expect blizzard pipes froze burst blizzard one get fix water flooded basement prayed blizzard did
follow the rainbow	pilot was flying plane rain storm saw rainbow decided see ended rainbow became followed did give end rainbow was parking lot cleaners pilot was disappointed did have end
the bad product	was looking socks online found pair reviews was decided risk quality disappointment socks were quality left review socks online
drinking challenge	considered drinker was bar night stranger challenged drinking challenge accepted won got ego drinking problem
summer body	was winter was shape wanted get shape summer started working eating time got looked got compliments
salads	went doctor doctor told was decided do something started bringing salads work eating sandwiches month had lost pounds
not as long as he thought	friend had go jail days was given midnight turn dropped night called come pick was hours was days
sight	was born eye age doctors said give eye sight had tissue donation eye operation terrified waking depth perception was feeling life
sports bar	loved watching sports sports bars decided get tray wings watch season game showed bar day was had used season schedule was days
girlfriend	girls were mystery tried make bought flowers chocolates found girl appreciated was became girlfriend boyfriend result
the smelly house	rich came home vacation was horrified reason house smelled wandered looking source smell found gallon milk table opened windows dissipate smell
salt	went school learned flavors home made chicken soup family played kinds seasonings spices soup did taste right mom added salt soup became
new stereo system	was going cruise friends had gotten brand stereo system car played tunes blast got pulled police police officer gave warning playing music
improving the memory	year takes partner place moving book flights place met place was bar moved year arrived find place was shut is star restaurant worked
dollar menu	was afternoon was nothing eat house had money started looking change couch cushions was get change dollar menu
tree man	day man climbed tree police were called man refused get tree waited hours man came was tired
catching a cold	felt was getting afford miss days work decided go work kept getting cold was blown went work got people
PERSON rescues the cat	is walking street day sees cat stuck tree tries call cat is does come climbs tree rescues cat
magazine party	had night had attend magazine party got hair makeup done walked tripped dress fall was
zen	enjoyed meditation wanted reach states meditation had heard zen learned learned zen applied techniques improved meditation
PERSON and the computer	liked working computers started business working computers accepted work started is overwhelmed work hired person help finish computers
baroque music	went study recorder came was banded group friends played music became sensation milieu
PERSON gets rescued	is going work has take elevator car elevator stops working calls help firemen rescue ted elevator
no shaving	was decided stop shaving figured having beard was trouble work did was forced go shaving
dead as a duck	aunt bought brother ducklings easter kids were see play day hurried aunt house play arrival realized were ants was lesson pet death were
money matters	mom lived time wanted talk had pay was money did call mother died paid thousands dollars take plane regretted having spent dollars talk
PERSON and her doll	had collection dolls bedroom had doll called day was school pet dog skippy found skippy chewed arms was devastated finding chewed doll
faker	went diner ordered breakfast decaf coffee server looked poured coffee sipped coffee knew gave coffee came food called server hung head shame gave tip
the opera	had been opera was excited see happen arrived opera house date took seat show began believe sounded was
sand in the car	was going vacation was taking family beach had time spent lot time sand family returned home had clean sand car
rainy	loved everything rainy liked smell sound lived west coast city summer visited got desire
the wingman	was friend friend met girl girl had friend wanted hang hung friend help
the sandwich	made sandwich was eat had knock door put sandwich coffee table forgot dog was roaming came dog had eaten sandwich
good service	were waiting restaurant server was made drinks were brought ticket dinner gave tip
the aroma	was date showered wanted smell cologne made cover part date turned be broke hives had go
PERSON buys a dress	was girl did have clothes nothing fit well went mall found salesperson salesperson picked dress fit decided buy
snowboarding	friend ate burger had feeling stomach eating hours fell went doctor cure illness doctor gave antibiotics get
calls	kept getting calls people calls came hours night day changed number problem stopped is gives number felt loved received calls
snack attack	sat bag popcorn turned tv ate handful tried find something watch found tv show watch looked bag was
stolen jacket	arrived work macy put coat room wanted go break went grab coat surprise coat was gone informed management coat was taken area coat was found offered replace
pretty	thought was whenever was friends dress visiting mall friends was spotted agent agent turned be recruiter modeling company is working model brand
bite	was walking saw straw cat decided pet cat bit got went doctors
brothers	closed door waited snuck jumped corner terrified caused tackle tickle cried love is thing
the suitcases	hated lugging suitcases storage trip had luggage room built house loved having designated spot luggage was pack retrieve bags room made organized
running man or dog	day took dog park walk walking runner runs going sprinted chase runner chased minutes caught sat tree enjoyed shade run
suprise	today was birthday woke bed decided make breakfast heard knocks doors got seat walked door opened door family were front
friday night basketball	friday night friends play basketball friday went gym play ball lot people showed did know got know were playing have lot friends play basketball
bikini blues	wanted bikini bring summer camp mom tried coax get one-piece prevailed packed bikini camp lake was thrilled be girl bikini diving platform saw made sense
PERSON tries to skateboard	friends love skateboard has been tried learn months made progress decided skateboarding was
the sandals	girl hated wearing shoes wear sandals was time go school insisted wear sandals was had sandals feet mom threw sandals was sleeping
the couch	noticed tear material couch went store bought needle thread sewed material couch shut days tear reopened brought couch upholsterer
piano practice	wanted learn play piano was start practiced school improved deal play song likes
fabric	woman cut fabric made pattern found pattern fabric was cut fabric pattern
waffles	bought waffle maker filled batter pressed sides waited had waffle ate found was
bartender school	wanted learn be bartender enrolled class community college showed hours class knowing expect ends having time learned make lots drinks makes drinks friends has
PERSON likes soup	soup is chicken soup 's kind soup eat day tries tomato soup tomato soup becomes soup decides try things
little girl lost	was years had cabbage patch wheels rode street day day rode way end road man truck hit pulled took home got house yelled aunt watching
starfish	walked beach house beach wanted watch sunset way stepped starfish picked starfish threw enjoyed sunset felt had done
a glass of wine	did like drink alcohol circumstances excused events include alcohol evening girlfriend offered glass wine decided drink beverage hoping like wine was change mind
plant	wanted liven apartment bought plant watered day watered plant died
lost dog	lost dog meant world put posters offered reward stranger called number told found had hit dog car killed
cable issues	amber turned television noticed cable was working called company was told was outage amber went store bought antenna installed television amber was watch channels issues
doughnut	wife bought dd artisan doughnuts were supposed have filling mine did have filling was going complain gave doughnut tasted ok
fat child	was grade school saw girl school bully is day decided talk offer sit canteen is became friends was one expected
the roller skating accident	loved roller skate did know shared interest decided go rollerskating block time surprise crashed rounded corner apologize became friends incident
the broken guitar	was getting show band was helping carry equipment stage tripped dropped guitar neck snapped leaving show someone was find replacement time
board games	was playing board games family was was losing ran room crying mother went comfort realized having family made winner
married	was was getting married was was sweating was be husband saw walk aisle nerves were gone said do kissed
floss stick	went eat night piece meat got stuck teeth have plate did want take public waited got home use floss stick taking piece meat brought relief
PERSON gets a new job	was laid job picked paper looked help wanted ads sent resumes companies got interview companies got job interviewed
blood drive	went employer blood drive volunteer gave forms fill turned forms lab tech set donation sat chair donated blood was done staff member gave cookie juice
daydreaming	pay attention class wandered mind thinking fantasies nonsense was medicated does class does fantasize
book report speech	had give speech book report speech had incorporate prop book dad helped make cardboard plastic diving helmet speech was stuttering got marks speech credit prop
late again	woke work morning rush get left watch nightstand arrived work was boss asked knew was did have watch told did know
exhausted	was exhausted soccer practice needed finish homework estimated take hours began work found nose desk am
night	night nurse called doctor doctor said baby was distress pitocin drip was stopped was left lying night doctor was coming help
close to death	made turn highway floors were car fell course jumped barriers grass suffered headache was get towing service took car
sick neighbor	lived door woman had seen woman days walked door visit neighbor found was visited everyday recovered
PERSON 's road trip .	was waiting paycheck come vacation was state road trip covering ca or was excited check came packed bags met friends drove states saw attractions adding joy end trip felt fulfilled work
the soccer injury .	was soccer player was middle game foot slid grass twisted ankle fell pain parents had take doctor
pokemon hunting	waking am brushed teeth did basics turned pokemon go made breakfast was shocked charizard is neighborhood throw food run door go run direction searching hunt begins set hopes finding
the stuffed puppy	had stuffed puppy day mother went post office put puppy mailbox mother was looking started screaming was mailman got puppy
on the road	family went road trip piled car snacks tow car broke mechanic fixed car sent way smith hit road found energy
heights	went wanted ride train was closed day repairs decided try pirate ship ended having lot fun conquering fear heights
playing in the bathroom	was playing bathroom flushed toilet paper toilet toilet got stopped began overflow got trouble stopping toilet
big shot	was town woods year day man came offered buy town people were excited had been struggling deal was concluded man was killed town ruined
budget	mom gave school clothes went mall excited saw clothes were realized afford mall clothes had go shopping department store
driving a car	was learning drive time tried crashed thought learn practiced ended passing driving test flying colors
basketball game	had basketball game tonight was team felt team ended winning game was relieved
video rivals	has lost video game day gets challenged puts fight utilizes skills potential ends winning
lost coins	was going do laundry find quarters asked roommate admitted used arcade made pay
beginner	wanted learn sing signed group singing class exercises realized was tune teacher coached gave encouragement let go self-consciousness improved
